[[16S_Ribosomal_RNA]]	[[Spectinomycin]],
[[30S]]	[[Spectinomycin]],[[List_Of_Antibiotics]],[[Kanamycin]],
[[30S_Ribosomal_Subunit]]	[[List_Of_Antibiotics]],
[[50S]]	[[List_Of_Antibiotics]],[[List_Of_Antibiotics]],
[[ABC_Transporter]]	[[Pyocyanin]],
[[ABC_Transporters]]	[[Antibiotic_Resistance]],
[[ABIM_Foundation]]	[[Antibiotic_Misuse]],[[Antibiotic_Misuse]],[[Antibiotic_Misuse]],[[Antibiotic_Misuse]],[[Antibiotic_Misuse]],[[Antibiotic_Misuse]],[[Antibiotic_Misuse]],[[Antibiotic_Misuse]],
[[ACE_Inhibitor]]	[[Medicinal_Mushroom]],
[[AG_Scientific]]	[[A23187]],
[[AIDS]]	[[Clofazimine]],[[Alliance_For_The_Prudent_Use_Of_Antibiotics]],[[Trimethoprim]],
[[ATC_Code_J01]]	[[Category:Antibiotic_Stubs]],
[[ATC_Code_J04]]	[[Template:Antimycobacterials]],
[[ATPase]]	[[A23187]],[[Novobiocin]],
[[Abbott_Laboratories]]	[[Promin]],
[[Abscess]]	[[Nitrofurantoin]],
[[Abscisic_Acid]]	[[Phytoalexin]],
[[Acedapsone]]	[[Template:Antimycobacterials]],
[[Acetaldehyde_Dehydrogenase]]	[[Medicinal_Mushroom]],[[Antibiotics]],
[[Acetate]]	[[Platensimycin]],[[Salinosporamide_A]],[[Mupirocin]],[[Carbomycin]],[[Nonribosomal_Peptide]],
[[Acetic]]	[[Endiandric_Acid_C]],
[[Acetic_Acid]]	[[Acetic_Acid/hydrocortisone]],[[Aspergillic_Acid]],
[[Acetone]]	[[Dalfopristin]],[[Monensin]],
[[Acetoxycycloheximide]]	[[Cycloheximide]],
[[Acetyl]]	[[Trichostatin_A]],[[Platensimycin]],
[[Acetyl_Transferase]]	[[Blasticidin_S]],
[[Acetylation]]	[[Bottromycin]],[[Isoniazid]],[[Isoniazid]],
[[Achromycin_V]]	[[List_Of_Antibiotics]],
[[Acid]]	[[Platensimycin]],[[Surfactin]],[[A23187]],
[[Acidic]]	[[Aspergillic_Acid]],
[[Acinetobacter]]	[[Trimethoprim]],[[Antibiotic_Resistance]],
[[Acinetobacter_Baumannii]]	[[Antibiotic_Resistance]],
[[Aclarubicin]]	[[Streptomyces_Isolates]],
[[Acne]]	[[List_Of_Antibiotics]],[[Dapsone]],
[[Acne_Conglobata]]	[[Dapsone]],
[[Acne_Fulminans]]	[[Dapsone]],
[[Acne_Vulgaris]]	[[Mupirocin]],[[Fusidic_Acid]],
[[Acta_Crystallographica_Section_D]]	[[Gramicidin_S]],
[[Actinobacteria]]	[[Novobiocin]],[[Netropsin]],[[Streptomyces_Isolates]],
[[Actinomycete]]	[[Ansamycin]],[[Macbecin]],[[Urauchimycin]],[[Etamycin]],
[[Actinomycetes]]	[[Debromomarinone]],[[Albert_Schatz_(scientist)]],[[Streptomyces_Isolates]],[[Marinone]],
[[Actinomycin]]	[[Streptomyces_Isolates]],[[Nonribosomal_Peptide]],
[[Actinoplanes]]	[[Actaplanin]],[[Ramoplanin]],
[[Actinoxanthin]]	[[Neocarzinostatin]],
[[Action_Medical_Research]]	[[Seraticin]],
[[Active_Hexose_Correlated_Compound]]	[[Medicinal_Mushroom]],
[[Active_Transport]]	[[Efflux_(microbiology)]],[[Efflux_(microbiology)]],
[[Acute_(medicine)]]	[[Trimethoprim/polymyxin]],
[[Acute_Otitis_Media]]	[[Erythromycin/sulfafurazole]],
[[Acyl]]	[[Nonribosomal_Peptide]],[[Surfactin]],[[Nonribosomal_Peptide]],
[[Acyl_Carrier_Protein]]	[[Mupirocin]],[[Mupirocin]],[[Echinomycin]],
[[Acylation]]	[[Nonribosomal_Peptide]],[[Zwittermicin_A]],[[Nonribosomal_Peptide]],
[[Acylcyclodepsipeptide]]	[[Katanosin]],
[[Acyltransferase]]	[[Mupirocin]],
[[Adamantane]]	[[Hexamethylenetetramine]],[[Hexamethylenetetramine]],
[[Addition]]	[[Dalfopristin]],
[[Adduct]]	[[Ethionamide]],
[[Adenosine]]	[[Medicinal_Mushroom]],
[[Adenosine_Monophosphate]]	[[Tyrocidine]],[[Nonribosomal_Peptide]],
[[Adenosine_Triphosphate]]	[[Cycloserine]],[[Efflux_(microbiology)]],[[Nonribosomal_Peptide]],[[Arenicin]],[[Novobiocin]],[[Novobiocin]],[[A23187]],[[Pyocyanin]],[[Fosfomycin]],[[Efflux_(microbiology)]],[[Tyrocidine]],
[[Adolf_Spiegel]]	[[Pulvinone]],
[[Adolph_Strecker]]	[[Pulvinone]],
[[Adsorption]]	[[Production_Of_Antibiotics]],
[[Adverse_Effect]]	[[Antibiotic_Misuse]],
[[Adverse_Effect_(medicine)]]	[[Kanamycin]],
[[Aeromonas]]	[[Trimethoprim]],
[[Afghanistan]]	[[Antibiotic_Resistance]],
[[Aflatoxin]]	[[Phytoalexin]],[[Cruciferous_Vegetables]],
[[African_Trypanosomiasis]]	[[Arsphenamine]],[[Ascofuranone]],
[[Agapanthoideae]]	[[Cruciferous_Vegetables]],
[[Agar]]	[[Kanamycin]],
[[Agar_Plate]]	[[Production_Of_Antibiotics]],
[[Agaricus_Bisporus]]	[[Medicinal_Mushroom]],
[[Agaricus_Subrufescens]]	[[Medicinal_Mushroom]],
[[Agglutination_(biology)]]	[[Ristocetin]],
[[Aglycone]]	[[Kedarcidin]],
[[Agonist]]	[[Cycloserine]],
[[Agranulocytosis]]	[[Dapsone]],
[[Agricultural_Research_Service]]	[[Avenanthramide]],
[[Agrocybe_Aegerita]]	[[Medicinal_Mushroom]],
[[Ajoene]]	[[Vinyldithiin]],
[[Ajoine]]	[[Allistatin]],
[[Akira_Endo_(biochemist)]]	[[Medicinal_Molds]],
[[Al:perime_Cruciferous]]	[[Cruciferous_Vegetables]],
[[Alamethicin]]	[[Peptaibol]],[[Medicinal_Molds]],[[Medicinal_Mushroom]],
[[Alanine]]	[[Telavancin]],[[Template:Antimycobacterials]],
[[Alanine_Racemase]]	[[Cycloserine]],
[[Alanine_Scan]]	[[Tyrocidine]],
[[Albomycin]]	[[Novobiocin]],
[[Albumin]]	[[Telavancin]],
[[Alcohol]]	[[List_Of_Antibiotics]],[[Nonribosomal_Peptide]],[[Pulvinone]],
[[Alcoholism]]	[[Isoniazid]],
[[Alcon]]	[[Tobramycin/dexamethasone]],
[[Aldehyde]]	[[Endiandric_Acid_C]],[[Nonribosomal_Peptide]],
[[Aldesulfone_Sodium]]	[[Template:Antimycobacterials]],
[[Aldose_Reductase_Inhibitor]]	[[Medicinal_Molds]],
[[Aleksandr_Butlerov]]	[[Hexamethylenetetramine]],
[[Alexander_Fleming]]	[[Antibiotic_Resistance]],[[Medicinal_Molds]],[[Antibiotics]],[[Antibiotics]],
[[Alexander_Malinovsky]]	[[Gramicidin_S]],
[[Alexander_The_Great]]	[[Calicheamicin]],
[[Alexandr_Solzhenitsyn]]	[[Medicinal_Mushroom]],
[[Alicante_(province)]]	[[Archaeocin]],
[[Alkali]]	[[Cycloheximide]],
[[Alkali_Metal]]	[[Beauvericin]],
[[Alkaline_Earth_Metal]]	[[Beauvericin]],
[[Alkaline_Phosphatase]]	[[Daptomycin]],
[[Alkaloid]]	[[Staurosporine]],[[Phytoalexin]],[[Staurosporine]],
[[Alkene]]	[[Kedarcidin]],
[[Alkylation]]	[[Hexamethylenetetramine]],[[Fosfomycin]],
[[Alkylresorcinol]]	[[DB-2073]],
[[Alkyne]]	[[Kedarcidin]],
[[Allergic]]	[[Kanamycin]],
[[Allergy]]	[[List_Of_Antibiotics]],[[Dapsone]],
[[Alliaceae]]	[[Allicin]],
[[Alliance_For_The_Prudent_Use_Of_Antibiotics]]	[[Antibiotic_Resistance]],[[Antibiotic_Misuse]],
[[Allicin]]	[[Allyl_Isothiocyanate]],[[Allistatin]],[[Vinyldithiin]],[[Phytoalexin]],
[[Alliin]]	[[Allicin]],[[Allistatin]],[[Allicin]],[[Vinyldithiin]],
[[Alliinase]]	[[Allicin]],[[Vinyldithiin]],[[Allicin]],
[[Allium]]	[[Allistatin]],
[[Allixin]]	[[Phytoalexin]],
[[Allyl_Chloride]]	[[Allyl_Isothiocyanate]],
[[Allyl_Isothiocyanate]]	[[Allicin]],
[[Allylamine]]	[[Allyl_Isothiocyanate]],
[[Alopecia]]	[[Nitrofurantoin]],
[[Alpha_Amylase]]	[[Medicinal_Mushroom]],
[[Alpha_Amylase_Inhibitor]]	[[Medicinal_Mushroom]],
[[Alpha_Glucosidase]]	[[Medicinal_Mushroom]],
[[Alternaria]]	[[Nonribosomal_Peptide]],
[[Alternative_Medicine]]	[[Albert_Schatz_(scientist)]],
[[Alternative_Oxidase]]	[[Ascofuranone]],
[[Aluminium_Chloride]]	[[Triclosan]],
[[Amblyopia]]	[[Nitrofurantoin]],
[[American_Academy_Of_Allergy,_Asthma,_And_Immunology]]	[[Antibiotic_Misuse]],
[[American_Academy_Of_Dermatology]]	[[Antibiotic_Misuse]],[[Antibiotic_Misuse]],
[[American_Dental_Association]]	[[Triclosan]],
[[American_Heart_Association]]	[[Antibiotic_Misuse]],
[[American_Journal_Of_Physiology]]	[[Pyocyanin]],
[[American_Medical_Association]]	[[Arsphenamine]],
[[American_Society_For_Microbiology]]	[[MC21-A]],
[[American_Society_Of_Hematology]]	[[Salinosporamide_A]],
[[Amide]]	[[Puromycin]],[[Nonribosomal_Peptide]],[[Bottromycin]],
[[Amide_Bond]]	[[Platensimycin]],
[[Amides]]	[[Platensimycin]],
[[Amidine]]	[[Bottromycin]],
[[Amikacin]]	[[List_Of_Antibiotics]],[[Template:Antimycobacterials]],
[[Amikin]]	[[List_Of_Antibiotics]],
[[Amiloride]]	[[Trimethoprim]],
[[Amine]]	[[User:Harmonslide/sandbox]],
[[Amino_Acid]]	[[Nonribosomal_Peptide]],[[Mupirocin]],[[Hydramacin-1]],[[Hydramacin-1]],[[Streptomyces_Isolates]],[[Efflux_(microbiology)]],[[Katanosin]],[[Archaeocin]],[[Peptaibol]],[[Myriocin]],
[[Amino_Acids]]	[[Surfactin]],[[AGG01]],[[Arenicin]],[[Ceragenin]],
[[Amino_Sugar]]	[[Actaplanin]],
[[Aminobenzoic_Acid]]	[[Platensimycin]],
[[Aminocoumarin]]	[[Novobiocin]],[[Novobiocin]],[[Coumermycin_A1]],[[Novobiocin]],[[Clorobiocin]],
[[Aminocyclitol]]	[[Spectinomycin]],
[[Aminoglycoside]]	[[Fosfomycin/tobramycin]],[[Antibiotics]],[[Streptomyces_Isolates]],[[Antibiotics]],[[Template:Antimycobacterials]],[[Kanamycin]],[[List_Of_Antibiotics]],[[Antibiotics]],
[[Aminoglycoside_Antibiotic]]	[[Tobramycin/dexamethasone]],[[Tobramycin/dexamethasone]],
[[Aminoglycosides]]	[[List_Of_Antibiotics]],[[Antibiotic_Resistance]],[[Spectinomycin]],[[Multidrug_Tolerance]],
[[Aminonucleoside]]	[[Puromycin]],
[[Aminopenicillin]]	[[Extended-spectrum_Penicillin]],
[[Ammonia]]	[[Hexamethylenetetramine]],[[Hexamethylenetetramine]],
[[Ammonium_Chloride]]	[[Carbomycin]],[[Hexamethylenetetramine]],
[[Ammonium_Dihydrogen_Phosphate]]	[[Carbomycin]],
[[Ammonium_Nitrate]]	[[Carbomycin]],
[[Amoebiasis]]	[[List_Of_Antibiotics]],
[[Amolops_Loloensis]]	[[Cathelicidin]],
[[Amoxicillin]]	[[NXL103]],[[List_Of_Antibiotics]],[[Nitrofurantoin]],[[Broad-spectrum_Antibiotic]],[[Streptomyces_Isolates]],
[[Amoxil]]	[[List_Of_Antibiotics]],
[[Amphipathic]]	[[Peptaibol]],[[Arenicin]],[[AGG01]],
[[Amphiphilic]]	[[Surfactin]],[[Efflux_(microbiology)]],
[[Amphotericin_B]]	[[Streptomyces_Isolates]],
[[Ampicillin]]	[[Endiandric_Acid_C]],[[List_Of_Antibiotics]],[[Mercer_Protocol]],[[Broad-spectrum_Antibiotic]],[[Antibiotic_Resistance]],[[Amp_Resistance]],
[[Amsacrine]]	[[Topoisomerase_Inhibitor]],[[Topoisomerase_Inhibitor]],
[[Amycolatopsis]]	[[Ansamycin]],[[Ristocetin]],
[[Amygdala]]	[[Cycloserine]],[[Cycloserine]],
[[Anaerobe]]	[[List_Of_Antibiotics]],[[List_Of_Antibiotics]],
[[Anaerobic_Bacteria]]	[[List_Of_Antibiotics]],
[[Anaphylactic_Reaction]]	[[List_Of_Antibiotics]],
[[Ancef]]	[[List_Of_Antibiotics]],
[[Ancient_Egyptian_Medicine]]	[[Antibiotics]],
[[Ancient_Greek_Medicine]]	[[Antibiotics]],
[[Andrastin_A]]	[[Medicinal_Molds]],
[[Anemia]]	[[Nitrofurantoin]],[[Daptomycin]],[[Dapsone]],
[[Angiogenesis]]	[[Herbimycin]],[[Geldanamycin]],
[[Angucycline]]	[[Moromycin]],[[Landomycin]],
[[Anhydride]]	[[Nonribosomal_Peptide]],
[[Anicequol]]	[[Medicinal_Molds]],
[[Anidulafungin]]	[[Medicinal_Molds]],
[[Animal_Drugs]]	[[Animal_Drug_Availability_Act_1996]],
[[Animal_Health]]	[[Animal_Drug_Availability_Act_1996]],
[[Animal_Husbandry]]	[[Antibiotic_Resistance]],[[Antibiotic_Misuse]],
[[Animal_Locomotion]]	[[Cycloserine]],
[[Animal_Model]]	[[Allyl_Isothiocyanate]],[[Platensimycin]],
[[Animal_Product]]	[[Antibiotic_Resistance]],
[[Animal_Repellent]]	[[Allyl_Isothiocyanate]],
[[Animal_Slaughter]]	[[Animal_Drug_Availability_Act_1996]],
[[Animal_Testing]]	[[Medicinal_Mushroom]],
[[Anion]]	[[Platensimycin]],
[[Anionic]]	[[AGG01]],
[[Ansamitocin]]	[[Ansamycin]],
[[Ansamycin]]	[[Geldanamycin]],[[Macbecin]],[[List_Of_Antibiotics]],[[Naphthomycin_A]],[[Herbimycin]],
[[Antcin_B]]	[[Medicinal_Mushroom]],[[Medicinal_Mushroom]],[[Medicinal_Mushroom]],
[[Anthranilic_Acid]]	[[Avenanthramide]],
[[Anthrax]]	[[Pyocyanase]],[[User:Harmonslide/sandbox]],
[[Antiamoebin]]	[[Medicinal_Molds]],
[[Antibacterial]]	[[Acetic_Acid/hydrocortisone]],[[Dapsone]],[[Dapsone]],[[Glycyrrhizol]],[[Surfactin]],[[Salinomycin]],[[Topoisomerase_Inhibitor]],[[Animal_Drug_Availability_Act_1996]],[[Bafilomycin]],[[Nifurquinazol]],[[Allyl_Isothiocyanate]],[[Furazolidone]],[[Aspergillic_Acid]],[[Thymineless_Death]],[[Monensin]],[[Bottromycin]],[[Nucleic_Acid_Inhibitor]],[[Leptomycin]],[[Allicin]],
[[Antibacterial_Activity]]	[[Endiandric_Acid_C]],
[[Antibacterial_Soap]]	[[Triclosan]],[[Antibiotic_Resistance]],
[[Antibiot_Annu]]	[[Thiostrepton]],
[[Antibiotic]]	[[Category:Antibiotic_Stubs]],[[Trimethoprim]],[[User:Harmonslide/sandbox]],[[Alliance_For_The_Prudent_Use_Of_Antibiotics]],[[Daptomycin]],[[Nitrofurantoin]],[[Triclosan]],[[Pristinamycin]],[[Pristinamycin]],[[Pristinamycin]],[[Hitachimycin]],[[Nonribosomal_Peptide]],[[Nonribosomal_Peptide]],[[Nonribosomal_Peptide]],[[Puromycin]],[[Puromycin]],[[Monensin]],[[Monensin]],[[Broad-spectrum_Antibiotic]],[[Geldanamycin]],[[Surfactin]],[[Aphidicolin]],[[Antibiotic_Sensitivity]],[[Antibiotic_Sensitivity]],[[Gliotoxin]],[[Chromomycin_A3]],[[Pyocyanase]],[[Nitrofural]],[[Herbimycin]],[[Ascofuranone]],[[Ethionamide]],[[Plectasin]],[[Spectinomycin]],[[Fosmidomycin]],[[Beauvericin]],[[Nigericin]],[[Nigericin]],[[Leptomycin]],[[Guanacastepene_A]],[[Roseophilin]],[[Streptolydigin]],[[Clofoctol]],[[Xibornol]],[[Nifuroxazide]],[[Neocarzinostatin]],[[Aminocoumarin]],[[A23187]],[[Blasticidin_S]],[[Tunicamycin]],[[Thiostrepton]],[[Allistatin]],[[Mupirocin]],[[Macbecin]],[[Ramoplanin]],[[Streptomyces_Isolates]],[[Surotomycin]],[[MC21-B]],[[Bambermycin]],[[Kidamycin]],[[Enviomycin]],[[Citromycin]],[[Netropsin]],[[Myxopyronin]],[[Dalfopristin]],[[Streptazolin]],[[Esperamicin]],[[Hedamycin]],[[MC21-A]],[[Questiomycin_A]],[[Eravacycline]],[[Brilacidin]],[[Avibactam]],[[Arylomycin_A2]],[[Yaequinolone_J1]],[[The_Demon_Under_The_Microscope]],[[The_Demon_Under_The_Microscope]],[[Platensimycin]],[[Pyrenocine]],[[Category:Combination_Antibiotics]],[[4-Aminosalicylic_Acid]],[[TAN-1057_A]],[[TAN-1057_C]],[[Melafix]],[[Lactivicin]],[[Echinomycin]],[[Pristinamycin_IA]],[[Efflux_(microbiology)]],[[Endiandric_Acid_C]],[[Amp_Resistance]],[[Bacteriostatic_Agent]],[[Actinorhodin]],[[Animal_Drug_Availability_Act_1996]],[[Carbomycin]],[[Antibiosis]],[[Archaeocin]],[[GSK_299423]],[[Erythromycin/sulfafurazole]],[[Hachimycin]],[[Lipoglycopeptide]],[[NXL103]],[[Taksta]],[[Peptaibol]],[[Calicheamicin]],[[Myriocin]],[[Novobiocin]],[[Extended-spectrum_Penicillin]],[[Multidrug_Tolerance]],[[Solithromycin]],[[Tobramycin/dexamethasone]],[[Cycloserine]],[[Trimethoprim/polymyxin]],[[Seraticin]],[[Fusidic_Acid]],[[Fusidic_Acid]],[[Antibiotic_Misuse]],[[Kanamycin]],[[Vinyldithiin]],[[Anthramycin]],[[Aspergillic_Acid]],[[Linopristin]],[[Validamycin]],[[Quinupristin]],[[Antibiotic_Resistance]],[[Enzybiotics]],[[DB-2073]],
[[Antibiotic_Resistance]]	[[Hexamethylenetetramine]],[[Resistome]],[[Animal_Drug_Availability_Act_1996]],[[Pulvinone]],[[Alliance_For_The_Prudent_Use_Of_Antibiotics]],[[Multidrug_Tolerance]],[[Antibiotic_Misuse]],[[Amp_Resistance]],[[Subtherapeutic_Antibiotic_Use_In_Swine]],[[Surfactin]],[[List_Of_Antibiotics]],[[User:Harmonslide/sandbox]],[[Efflux_(microbiology)]],[[Multidrug_Tolerance]],[[Antibiotic_Sensitivity]],
[[Antibiotic_Sensitivity]]	[[Antibiotic_Misuse]],[[Multidrug_Tolerance]],[[Multidrug_Tolerance]],
[[Antibiotic_Susceptibility_Testing]]	[[Nitrofurantoin]],
[[Antibiotic_Use_In_Livestock]]	[[Subtherapeutic_Antibiotic_Use_In_Swine]],[[Antibiotics]],[[Antibiotic_Resistance]],
[[Antibiotics]]	[[Dapsone]],[[Resistome]],[[Aminocoumarin]],[[Delvotest]],[[Katanosin]],[[Reuterin]],[[Polyoxins]],[[Antibiotic_Resistance]],[[Subtherapeutic_Antibiotic_Use_In_Swine]],[[Monensin]],[[List_Of_Antibiotics]],[[Lipopeptide]],[[Antibiosis]],[[Echinomycin]],[[Netropsin]],[[Bafilomycin]],[[Production_Of_Antibiotics]],
[[Antibody]]	[[Antibiotics]],
[[Anticancer]]	[[Thymineless_Death]],[[Kidamycin]],
[[Anticancer_Agents]]	[[Salinosporamide_A]],
[[Anticholinergic]]	[[Tobramycin/dexamethasone]],
[[Antifolate]]	[[Nucleic_Acid_Inhibitor]],[[Template:Antimycobacterials]],
[[Antifungal]]	[[Allicin]],
[[Antifungal_Drug]]	[[Streptomyces_Isolates]],
[[Antifungal_Medication]]	[[Nucleic_Acid_Inhibitor]],[[Bafilomycin]],[[Acetic_Acid/hydrocortisone]],[[Acetic_Acid/hydrocortisone]],[[Streptazolin]],[[Gliotoxin]],
[[Antileprotic_Drugs]]	[[Solasulfone]],
[[Antimalarial]]	[[Thymineless_Death]],
[[Antimalarial_Drug]]	[[Fosmidomycin]],
[[Antimetabolite]]	[[Nucleic_Acid_Inhibitor]],
[[Antimicrobial]]	[[Hydramacin-1]],[[Plectasin]],[[Trimethoprim/polymyxin]],[[Ansamycin]],[[Phytoalexin]],[[Animal_Drug_Availability_Act_1996]],[[Alliance_For_The_Prudent_Use_Of_Antibiotics]],[[Multidrug_Tolerance]],[[Archaeocin]],
[[Antimicrobial_Agents_And_Chemotherapy]]	[[Solithromycin]],[[(6S)-6-Fluoroshikimic_Acid]],[[MC21-A]],
[[Antimicrobial_Peptides]]	[[Tachyplesin]],[[Archaeocin]],[[Arenicin]],
[[Antimicrobial_Resistance]]	[[Fusidic_Acid]],
[[Antimycin]]	[[Urauchimycin]],
[[Antimycobacterial]]	[[Ethambutol]],[[Template:Antimycobacterials]],
[[Antineoplastic]]	[[List_Of_Antibiotics]],[[Hitachimycin]],[[Bafilomycin]],[[Tanespimycin]],
[[Antioxidant]]	[[Avenanthramide]],[[Allicin]],[[Vinyldithiin]],
[[Antioxidative]]	[[Phytoalexin]],
[[Antiporter]]	[[Efflux_(microbiology)]],[[Monensin]],[[Nigericin]],
[[Antipredator_Adaptation]]	[[Spectinomycin]],
[[Antiprotozoal]]	[[Allicin]],
[[Antipruritic]]	[[Avenanthramide]],
[[Antipseudomonal]]	[[Antibiotics]],
[[Antisense_RNA]]	[[Platensimycin]],
[[Antiseptic]]	[[Platensimycin]],[[Ambazone]],[[Acetic_Acid/hydrocortisone]],[[Bacteriostatic_Agent]],
[[Antithrombotic]]	[[Vinyldithiin]],
[[Antituberculosis]]	[[List_Of_Antibiotics]],[[List_Of_Antibiotics]],[[List_Of_Antibiotics]],[[List_Of_Antibiotics]],[[List_Of_Antibiotics]],[[List_Of_Antibiotics]],[[List_Of_Antibiotics]],[[List_Of_Antibiotics]],
[[Antitumour]]	[[Anthramycin]],[[Alazopeptin]],
[[Antiviral]]	[[Allicin]],
[[Antiviral_Drug]]	[[Surfactin]],[[Alliance_For_The_Prudent_Use_Of_Antibiotics]],[[Netropsin]],[[Antibiotics]],[[Gliotoxin]],
[[Antrocamphin_B]]	[[Medicinal_Mushroom]],
[[Antrodioxolanone]]	[[Medicinal_Mushroom]],[[Medicinal_Mushroom]],[[Medicinal_Mushroom]],
[[Anxiety]]	[[Antibiotic_Misuse]],
[[Aphidicolin]]	[[Medicinal_Molds]],[[Medicinal_Molds]],
[[Apicidin]]	[[Medicinal_Molds]],
[[Aplastic_Anemia]]	[[List_Of_Antibiotics]],[[Dapsone]],
[[Apolipoprotein]]	[[Kedarcidin]],
[[Apoptosis]]	[[Herbimycin]],[[Salinomycin]],[[Phytoalexin]],[[Staurosporine]],[[Geldanamycin]],[[Gliotoxin]],[[Geldanamycin]],[[Pyocyanin]],[[Aphidicolin]],[[Trichostatin_A]],
[[Apple_Juice]]	[[4-Aminosalicylic_Acid]],
[[Approvable_Letter]]	[[Telavancin]],
[[Aquaculture]]	[[Furazolidone]],
[[Aquarium]]	[[Melafix]],
[[Aquayamycin]]	[[Saquayamycin]],
[[Aqueous_Cream]]	[[Allicin]],
[[Arabinogalactan]]	[[Template:Antimycobacterials]],[[Ethambutol]],
[[Arabinosyl_Transferase]]	[[Ethambutol]],
[[Arabinosyltransferase]]	[[Template:Antimycobacterials]],
[[Aranjuez]]	[[Fosfomycin]],
[[Arbuscular_Mycorrhiza]]	[[Medicinal_Mushroom]],[[Medicinal_Molds]],
[[Archaea]]	[[Archaeocin]],[[Archaeocin]],
[[Archives_Of_Internal_Medicine]]	[[Allicin]],
[[Arginine]]	[[AGG01]],
[[Aromatase]]	[[Medicinal_Mushroom]],
[[Aromaticity]]	[[Efflux_(microbiology)]],
[[Arsenic]]	[[Arsphenamine]],
[[Arsphenamine]]	[[List_Of_Antibiotics]],
[[Artemisinin]]	[[Medicinal_Molds]],
[[Arthralgia]]	[[Ethambutol]],[[Daptomycin]],
[[Arthritis]]	[[Antibiotic_Resistance]],
[[Ascidian]]	[[Halocyamine]],
[[Ascochyta_Viciae]]	[[Ascofuranone]],
[[Ascomycin]]	[[Streptomyces_Isolates]],
[[Ascomycota]]	[[Medicinal_Molds]],
[[Ascorbic_Acid]]	[[Hexamethylenetetramine]],
[[Ashbya_Gossypii]]	[[Kanamycin]],
[[Asparaginase]]	[[Medicinal_Molds]],[[Streptomyces_Isolates]],
[[Asparagine]]	[[Surfactin]],[[Katanosin]],
[[Aspartate]]	[[Cycloserine]],
[[Aspergillus]]	[[Pulvinone]],[[Aspergillic_Acid]],[[Pulvinone]],
[[Aspergillus_Flavus]]	[[Aspergillic_Acid]],
[[Aspergillus_Fumigatus]]	[[Gliotoxin]],
[[Aspergillus_Oryzae]]	[[Medicinal_Molds]],[[Medicinal_Mushroom]],
[[Aspergillus_Terreus]]	[[Medicinal_Mushroom]],
[[Aspergillusol_A]]	[[Medicinal_Molds]],
[[Assay]]	[[Platensimycin]],
[[Associative_Learning]]	[[Cycloserine]],[[Cycloserine]],
[[Astraeus_Hygrometricus]]	[[Medicinal_Mushroom]],
[[Atherosclerosis]]	[[Allicin]],
[[Atomic_Mass_Unit]]	[[Antibiotics]],[[Archaeocin]],
[[Atopic_Dermatitis]]	[[Avenanthramide]],
[[Atoxyl]]	[[Arsphenamine]],
[[Atrial_Septal_Defect]]	[[Nitrofurantoin]],
[[Atromentin]]	[[Medicinal_Mushroom]],
[[Aurantiamine]]	[[Medicinal_Molds]],
[[Auricularia_Auricula]]	[[Medicinal_Mushroom]],
[[Auricularia_Polytricha]]	[[Medicinal_Mushroom]],
[[Aurintricarboxylic_Acid]]	[[Topoisomerase_Inhibitor]],
[[Australian_Medicines_Handbook]]	[[Dapsone]],
[[Austrocortilutein]]	[[Medicinal_Mushroom]],
[[Austrocortirubin]]	[[Medicinal_Mushroom]],
[[Autoimmune]]	[[Antibiotics]],
[[Autoimmunity]]	[[Efflux_(microbiology)]],
[[Autopsy]]	[[Clofazimine]],
[[Auxotrophic]]	[[Antibiotic_Resistance]],
[[Auxotrophy]]	[[Kanamycin]],
[[Avelox]]	[[List_Of_Antibiotics]],
[[Avibactam]]	[[Antibiotics]],
[[Avoparcin]]	[[Animal_Drug_Availability_Act_1996]],
[[Azactam]]	[[List_Of_Antibiotics]],
[[Azelaic_Acid]]	[[Mupirocin]],
[[Azithromycin]]	[[Solithromycin]],[[List_Of_Antibiotics]],
[[Azlocillin]]	[[List_Of_Antibiotics]],[[Extended-spectrum_Penicillin]],
[[Azobenzene]]	[[Arsphenamine]],
[[Azole]]	[[User:Harmonslide/sandbox]],
[[Azoxystrobin]]	[[Medicinal_Molds]],[[Medicinal_Mushroom]],
[[Aztreonam]]	[[List_Of_Antibiotics]],
[[BBC_News_Online]]	[[Ceragenin]],
[[Baccatin_III]]	[[Medicinal_Molds]],[[Medicinal_Molds]],
[[Bacillithiol]]	[[Fosfomycin]],
[[Bacillus]]	[[Triclosan]],
[[Bacillus_Amyloliquefaciens]]	[[User:Harmonslide/sandbox]],[[User:Harmonslide/sandbox]],
[[Bacillus_Anthracis]]	[[User:Harmonslide/sandbox]],[[User:Harmonslide/sandbox]],[[Antibiotics]],
[[Bacillus_Brevis]]	[[Tyrocidine]],
[[Bacillus_Cereus]]	[[Zwittermicin_A]],
[[Bacillus_Isolates]]	[[Medicinal_Molds]],[[Streptomyces_Isolates]],
[[Bacillus_Licheniformis]]	[[Antibiotic_Resistance]],
[[Bacillus_Pumilus]]	[[User:Harmonslide/sandbox]],
[[Bacillus_Subtilis]]	[[Surfactin]],[[Streptomyces_Isolates]],[[AGG01]],[[Endiandric_Acid_C]],[[Streptomyces_Isolates]],
[[Bacitracin]]	[[List_Of_Antibiotics]],[[Nonribosomal_Peptide]],
[[Backbone_Chain]]	[[Platensimycin]],
[[Bacteraemia]]	[[Daptomycin]],
[[Bacteremia]]	[[Antibiotic_Resistance]],
[[Bacteria]]	[[Streptomyces_Isolates]],[[Triclosan]],[[Spectinomycin]],[[Allistatin]],[[Surfactin]],[[Broad-spectrum_Antibiotic]],[[Broad-spectrum_Antibiotic]],[[Antibiosis]],[[Streptolydigin]],[[Lipopeptide]],[[Furazolidone]],[[Bacteriostatic_Agent]],[[List_Of_Antibiotics]],[[Dapsone]],[[Lactivicin]],[[Surotomycin]],[[Clofoctol]],[[Multidrug_Tolerance]],[[Bacteriostatic_Agent]],[[Tunicamycin]],[[Endiandric_Acid_C]],[[Alliance_For_The_Prudent_Use_Of_Antibiotics]],[[Beauvericin]],[[Nigericin]],[[Plectasin]],[[Kanamycin]],[[Antibiotic_Sensitivity]],[[A23187]],[[Resistome]],[[Aminocoumarin]],[[Multidrug_Tolerance]],
[[Bacteria_Strain]]	[[Animal_Drug_Availability_Act_1996]],
[[Bacterial]]	[[Trimethoprim/polymyxin]],[[Spectinomycin]],
[[Bacterial_Conjugation]]	[[Antibiotic_Resistance]],
[[Bacterial_Diarrhea]]	[[List_Of_Antibiotics]],
[[Bacterial_Endocarditis]]	[[Carbomycin]],
[[Bacterial_Infection]]	[[Antibiotics]],[[Animal_Drug_Availability_Act_1996]],
[[Bacterial_Outer_Membrane]]	[[List_Of_Antibiotics]],
[[Bacterial_Prostatitis]]	[[List_Of_Antibiotics]],
[[Bacterial_Wall]]	[[Bambermycin]],
[[Bactericidal]]	[[List_Of_Antibiotics]],[[Arenicin]],[[Antibiotic_Sensitivity]],[[Telavancin]],[[Aspergillic_Acid]],[[Dalfopristin]],[[Nitrofural]],[[Isoniazid]],[[Antibiotics]],[[Mupirocin]],
[[Bactericide]]	[[Nitrofurantoin]],[[User:Harmonslide/sandbox]],[[Bacteriostatic_Agent]],[[Antibiotics]],
[[Bacteriocidal]]	[[Kanamycin]],[[Bacteriostatic_Agent]],[[Nitrofurantoin]],
[[Bacteriophages]]	[[Antibiotic_Resistance]],[[Enzybiotics]],
[[Bacteriostatic]]	[[Fusidic_Acid]],[[Ethambutol]],[[Mupirocin]],[[Triclosan]],[[Isoniazid]],[[Nitrofurantoin]],[[Fusidic_Acid]],[[Trimethoprim]],[[Clofoctol]],[[Ethambutol]],[[Antibiotic_Sensitivity]],[[Dalfopristin]],[[Antibiotics]],[[List_Of_Antibiotics]],
[[Bacteriostatic_Agent]]	[[Ambazone]],[[Antibiotics]],
[[Bacterium]]	[[Nonribosomal_Peptide]],[[MC21-A]],[[Mupirocin]],[[MC21-B]],[[Arsphenamine]],
[[Bacteroides_Fragilis]]	[[Fusidic_Acid]],
[[Bactrim]]	[[List_Of_Antibiotics]],
[[Bactroban]]	[[List_Of_Antibiotics]],
[[Barceloneic_Acid_A]]	[[Medicinal_Molds]],
[[Barceloneic_Acid_B]]	[[Medicinal_Molds]],
[[Barley]]	[[Beauvericin]],
[[Barry_Trost]]	[[Roseophilin]],
[[Base_Pair]]	[[Archaeocin]],
[[Basement_Membrane]]	[[Hexamethylenetetramine]],
[[Basic_(chemistry)]]	[[Triclosan]],
[[Basolateral_Amygdala]]	[[Cycloserine]],
[[Bayer]]	[[Antibiotics]],[[Ambazone]],[[The_Demon_Under_The_Microscope]],
[[Beauveria_Bassiana]]	[[Beauvericin]],
[[Beauvericin]]	[[Medicinal_Molds]],
[[Bedaquiline]]	[[Template:Antimycobacterials]],
[[Beecham_(pharmaceutical_Company)]]	[[Mupirocin]],
[[Beilschmiedia]]	[[Endiandric_Acid_C]],
[[Belgium]]	[[Thiocarlide]],
[[Benzene]]	[[Monensin]],
[[Benzoate]]	[[Kedarcidin]],
[[Benzoquinone]]	[[Geldanamycin]],[[Herbimycin]],
[[Benzyne]]	[[Kedarcidin]],
[[Bergman_Cyclization]]	[[Enediyne]],[[Kedarcidin]],[[Kedarcidin]],[[Neocarzinostatin]],[[Calicheamicin]],
[[Beta_Hairpin]]	[[Arenicin]],
[[Betamethasone]]	[[Fusidic_Acid]],[[Fusidic_Acid]],
[[Betulin]]	[[Medicinal_Mushroom]],
[[Betulinic_Acid]]	[[Medicinal_Mushroom]],
[[Bialaphos]]	[[Streptomyces_Isolates]],
[[Biaxin]]	[[List_Of_Antibiotics]],
[[Bicarbonate]]	[[Daptomycin]],
[[Bicyclic_Molecule]]	[[Salinosporamide_A]],
[[Bifidobacterium]]	[[Bambermycin]],
[[Bile]]	[[Nitrofurantoin]],
[[Bill_Clinton]]	[[Animal_Drug_Availability_Act_1996]],
[[Bimodal_Distribution]]	[[Isoniazid]],
[[Bioaccumulate]]	[[Triclosan]],
[[Bioaccumulation]]	[[Triclosan]],
[[Bioassay]]	[[Leptomycin]],
[[Bioavailability]]	[[Cruciferous_Vegetables]],[[Nitrofurantoin]],
[[Biochemical_Pharmacology]]	[[Topoisomerase_Inhibitor]],
[[Biochemist]]	[[Endiandric_Acid_C]],
[[Biochemistry]]	[[Surfactin]],
[[Biocide]]	[[Triclosan]],[[Triclosan]],
[[Biofilm]]	[[Multidrug_Tolerance]],[[Multidrug_Tolerance]],
[[Biological_Fitness]]	[[Antibiotics]],
[[Biological_Interaction]]	[[Antibiosis]],
[[Biological_Membrane]]	[[Telavancin]],[[Monensin]],
[[Biological_Pest_Control]]	[[Antibiosis]],
[[Biology]]	[[Tunicamycin]],
[[Biomedical_Advanced_Research_And_Development_Authority]]	[[Antibiotic_Resistance]],
[[Biomedical_Sciences]]	[[Surfactin]],
[[Biomimetic_Synthesis]]	[[User:Harmonslide/sandbox]],[[Endiandric_Acid_C]],
[[Biosensors_And_Bioelectronics]]	[[Monensin]],
[[Biosynthesis]]	[[Antibiotics]],[[Nonribosomal_Peptide]],[[User:Harmonslide/sandbox]],[[Kedarcidin]],[[Polyoxins]],[[Carbomycin]],[[Kedarcidin]],[[Cycloserine]],[[Platensimycin]],[[Zwittermicin_A]],
[[Biosynthesis_Of_Doxorubicin]]	[[Streptomyces_Isolates]],
[[Biosynthetic_Pathway]]	[[Bottromycin]],
[[Biosythesis]]	[[Endiandric_Acid_C]],
[[Biotechnology]]	[[Streptomyces_Isolates]],[[Antibiosis]],
[[Biotechnology_In_Pharmaceutical_Manufacturing]]	[[Streptomyces_Isolates]],
[[Biphenyl]]	[[MC21-A]],
[[Birth_Defect]]	[[Cycloheximide]],
[[Bisnoryangonin]]	[[Endiandric_Acid_C]],
[[Black_Pepper]]	[[Allicin]],[[Allyl_Isothiocyanate]],
[[Blackstrap_Molasses]]	[[Carbomycin]],
[[Blasticidin]]	[[Albomycin]],
[[Blazein]]	[[Medicinal_Mushroom]],
[[Bleomycin]]	[[Esperamicin]],[[Nonribosomal_Peptide]],[[Streptomyces_Isolates]],
[[Blood_Plasma]]	[[Ristocetin]],
[[Blood_Pressure]]	[[Allicin]],
[[Body_Weight]]	[[Animal_Drug_Availability_Act_1996]],
[[Boiling_Point]]	[[Dalfopristin]],
[[Bok_Choy]]	[[Cruciferous_Vegetables]],
[[Boletus]]	[[Pulvinone]],
[[Boletus_Edulis]]	[[Medicinal_Mushroom]],
[[Bone_Marrow]]	[[Trimethoprim]],
[[Borden_(company)]]	[[Hexamethylenetetramine]],
[[Bortezomib]]	[[Salinosporamide_A]],
[[Boston,_Massachusetts]]	[[Alliance_For_The_Prudent_Use_Of_Antibiotics]],
[[Botrytis_Cinerea]]	[[Phytoalexin]],[[Phytoalexin]],
[[Brassica]]	[[Cruciferous_Vegetables]],
[[Brassica_Juncea]]	[[Allyl_Isothiocyanate]],
[[Brassica_Nigra]]	[[Cruciferous_Vegetables]],[[Allyl_Isothiocyanate]],
[[Brassica_Oleracea]]	[[Cruciferous_Vegetables]],
[[Brassicaceae]]	[[Cruciferous_Vegetables]],
[[Brazil]]	[[Nitrofurantoin]],
[[Breast_Cancer]]	[[Salinomycin]],[[Triclosan]],
[[Bredinin]]	[[Medicinal_Molds]],
[[Brefeldin_A]]	[[Medicinal_Molds]],[[Medicinal_Mushroom]],[[Medicinal_Mushroom]],
[[Brevibacterium]]	[[User:Harmonslide/sandbox]],
[[Brigham_Young_University]]	[[Ceragenin]],
[[Brilacidin]]	[[Antibiotics]],
[[British_Approved_Name]]	[[Thioacetazone]],
[[British_Medical_Journal]]	[[Antibiotic_Resistance]],
[[British_Museum]]	[[Antibiotic_Resistance]],
[[Broad_Institute]]	[[Salinomycin]],[[Salinomycin]],
[[Broccoflower]]	[[Cruciferous_Vegetables]],
[[Broccoli]]	[[Raphanin]],[[Cruciferous_Vegetables]],[[Cruciferous_Vegetables]],
[[Bromocriptine]]	[[Medicinal_Molds]],[[Medicinal_Mushroom]],
[[Brooklyn_College]]	[[Albert_Schatz_(scientist)]],[[Albert_Schatz_(scientist)]],
[[Brown_Recluse]]	[[Dapsone]],
[[Brown_Recluse_Spider]]	[[Dapsone]],
[[Brussels]]	[[Thiocarlide]],
[[Brussels_Sprouts]]	[[Cruciferous_Vegetables]],
[[Burkholderia_Cepacia]]	[[Trimethoprim]],
[[Burkholderia_Pseudomallei]]	[[Trimethoprim]],
[[Burn]]	[[List_Of_Antibiotics]],
[[Butenolide]]	[[Pulvinone]],[[Pulvinone]],[[Pulvinone]],
[[CCL5]]	[[Pyocyanin]],
[[CSIRO]]	[[Antibiotic_Resistance]],
[[CSSSI]]	[[Telavancin]],
[[CYP1A2]]	[[Cruciferous_Vegetables]],
[[CYP2E1]]	[[Dapsone]],
[[CYP3A4]]	[[Telavancin]],[[Dalfopristin]],
[[CYP3A5]]	[[Telavancin]],
[[Cabbage]]	[[Cruciferous_Vegetables]],[[Cruciferous_Vegetables]],
[[Cabergoline]]	[[Medicinal_Molds]],[[Medicinal_Mushroom]],
[[Caenorhabditis_Elegans]]	[[Pyocyanin]],
[[Cafergot]]	[[Medicinal_Molds]],[[Medicinal_Mushroom]],
[[Caister_Academic_Press]]	[[Antibiotics]],[[Antibiotics]],
[[Cajeput_Tree]]	[[Melafix]],
[[Calcitonin]]	[[Raphanin]],
[[Calcium]]	[[Aspergillic_Acid]],[[Surfactin]],
[[Calcium_Aminosalicylate]]	[[Template:Antimycobacterials]],
[[Calcium_Dependent_Antibiotic]]	[[Nonribosomal_Peptide]],
[[Calicheamicin]]	[[Enediyne]],[[Kedarcidin]],[[Kedarcidin]],[[Enediyne]],[[Esperamicin]],
[[Cameroon]]	[[Endiandric_Acid_C]],
[[Camptothecin]]	[[Topoisomerase_Inhibitor]],[[Medicinal_Molds]],
[[Campylobacter]]	[[Animal_Drug_Availability_Act_1996]],[[Antibiotic_Resistance]],
[[Campylobacter_Coli]]	[[Trimethoprim]],
[[Campylobacter_Jejuni]]	[[Trimethoprim]],
[[Campylobacteriosis]]	[[Subtherapeutic_Antibiotic_Use_In_Swine]],
[[Canada]]	[[Endiandric_Acid_C]],
[[Canadian_Medical_Association]]	[[Triclosan]],
[[Cancer]]	[[Topoisomerase_Inhibitor]],[[Antibiotics]],[[A23187]],[[Vinyldithiin]],[[Trichostatin_A]],[[Tanespimycin]],
[[Cancer_Immunotherapy]]	[[Medicinal_Mushroom]],
[[Cancer_Research_UK]]	[[Medicinal_Mushroom]],[[Medicinal_Mushroom]],
[[Cancer_Stem_Cells]]	[[Salinomycin]],
[[Cancer_Ward]]	[[Medicinal_Mushroom]],
[[Cancers]]	[[Avenanthramide]],
[[Candida_(genus)]]	[[Gliotoxin]],[[Antibiotics]],
[[Candidiasis]]	[[Broad-spectrum_Antibiotic]],
[[Cannabidiol]]	[[Topoisomerase_Inhibitor]],
[[Canola]]	[[Cruciferous_Vegetables]],
[[Capreomycin]]	[[Template:Antimycobacterials]],[[List_Of_Antibiotics]],
[[Capsaicin]]	[[Allicin]],[[Allyl_Isothiocyanate]],
[[Capsid]]	[[Surfactin]],
[[Capsidiol]]	[[Phytoalexin]],
[[Carbacephem]]	[[List_Of_Antibiotics]],
[[Carbamoyl]]	[[Novobiocin]],
[[Carbapenem]]	[[List_Of_Antibiotics]],[[Lenapenem]],[[Antibiotics]],[[Antibiotic_Resistance]],[[Antibiotics]],
[[Carbapenem_Resistant_Enterobacteriaceae]]	[[Antibiotic_Resistance]],
[[Carbapenems]]	[[Broad-spectrum_Antibiotic]],
[[Carbazole]]	[[Staurosporine]],
[[Carbenicillin]]	[[Extended-spectrum_Penicillin]],[[List_Of_Antibiotics]],
[[Carbon]]	[[Surfactin]],[[Carbomycin]],
[[Carboxylate]]	[[Platensimycin]],
[[Carboxypenicillin]]	[[Extended-spectrum_Penicillin]],[[Extended-spectrum_Penicillin]],
[[Carcinogen]]	[[Cruciferous_Vegetables]],
[[Cardiac_Disease]]	[[Dapsone]],
[[Cardiospermum_Halicacabum]]	[[Medicinal_Molds]],
[[Cardiovascular_Disease]]	[[Vinyldithiin]],
[[Carotenoid]]	[[Efflux_(microbiology)]],
[[Carrier_Protein]]	[[Kedarcidin]],
[[Caseous_Necrosis]]	[[Isoniazid]],
[[Caspofungin]]	[[Lipopeptide]],[[Medicinal_Molds]],[[Medicinal_Mushroom]],
[[Catalase]]	[[Pyocyanin]],
[[Catalyst]]	[[Aspergillic_Acid]],
[[Cataract]]	[[Tobramycin/dexamethasone]],
[[Category:1922_Births]]	[[Albert_Schatz_(scientist)]],
[[Category:1996_In_Law]]	[[Animal_Drug_Availability_Act_1996]],
[[Category:1996_In_The_United_States]]	[[Animal_Drug_Availability_Act_1996]],
[[Category:2005_Deaths]]	[[Albert_Schatz_(scientist)]],
[[Category:2006_Books]]	[[The_Demon_Under_The_Microscope]],
[[Category:Acetamides]]	[[Thiolutin]],
[[Category:Acetanilides]]	[[Thioacetazone]],
[[Category:Acetate_Esters]]	[[Fusidic_Acid]],[[Guanacastepene_A]],
[[Category:Acetic_Acids]]	[[Actinorhodin]],
[[Category:Alcohols]]	[[Salinomycin]],[[Fusidic_Acid]],[[Guanacastepene_A]],[[Gliotoxin]],[[Narasin]],[[17-Dimethylaminoethylamino-17-demethoxygeldanamycin]],[[Cycloheximide]],[[Geldanamycin]],[[Lasalocid]],[[Ethambutol]],[[Tanespimycin]],
[[Category:Aldehydes]]	[[Guanacastepene_A]],[[Ascofuranone]],
[[Category:Alkaloids]]	[[TAN-1057_A]],[[Staurosporine]],[[TAN-1057_C]],
[[Category:Alkenes]]	[[Fusidic_Acid]],[[Allicin]],[[Vinyldithiin]],
[[Category:Alkylresorcinols]]	[[DB-2073]],
[[Category:Allioideae]]	[[Vinyldithiin]],
[[Category:Allium]]	[[Allistatin]],[[Allicin]],[[Vinyldithiin]],
[[Category:American_Environmentalists]]	[[Albert_Schatz_(scientist)]],
[[Category:American_People_Of_English_Descent]]	[[Albert_Schatz_(scientist)]],
[[Category:American_Scientists]]	[[Albert_Schatz_(scientist)]],
[[Category:American_Socialists]]	[[Albert_Schatz_(scientist)]],
[[Category:Amides]]	[[TAN-1057_A]],
[[Category:Amines]]	[[Arsphenamine]],
[[Category:Amino_Acids]]	[[Myriocin]],
[[Category:Amino_Sugars]]	[[Kidamycin]],[[Validamycin]],
[[Category:Aminoglycoside_Antibiotics]]	[[Kanamycin]],[[Fosfomycin/tobramycin]],
[[Category:Analgesics]]	[[Pulvinone]],
[[Category:Anilides]]	[[Platensimycin]],
[[Category:Anilines]]	[[Dapsone]],[[4-Aminosalicylic_Acid]],[[Trichostatin_A]],[[Promin]],
[[Category:Anthraquinone_Glycosides]]	[[Chromomycin_A3]],
[[Category:Antibiotic_Resistance]]	[[Antibiotic_Resistance]],[[Resistome]],[[Antibiotic_Misuse]],
[[Category:Antibiotics]]	[[Avibactam]],[[Mercer_Protocol]],[[CMV423]],[[Arylomycin_A2]],[[Brilacidin]],[[Yaequinolone_J1]],[[Caprazamycin]],[[Quinupristin]],[[The_Demon_Under_The_Microscope]],[[Delvotest]],[[Eravacycline]],[[Etamycin]],[[Daptomycin]],[[Streptonigrin]],[[Hydramacin-1]],[[Pyrenocine]],[[Fosmidomycin]],[[Enzybiotics]],[[Fusidic_Acid]],[[Questiomycin_A]],[[Beauvericin]],[[Halocyamine]],[[Fosfomycin/tobramycin]],[[Omadacycline]],[[Albert_Schatz_(scientist)]],[[Nocathiacin_I]],[[Mannopeptimycin_Glycopeptide]],[[Hexamethylenetetramine]],[[Tachyplesin]],[[Gramicidin_S]],[[Saquayamycin]],[[Saptomycin]],[[Hitachimycin]],[[Lenapenem]],[[Marinone]],[[Platensimycin]],[[Debromomarinone]],[[MC21-A]],[[Alliance_For_The_Prudent_Use_Of_Antibiotics]],[[4-Aminosalicylic_Acid]],[[Helquinoline]],[[TAN-1057_A]],[[Glycyrrhizol]],[[Moromycin]],[[Validamycin]],[[TAN-1057_C]],[[Hedamycin]],[[Kettapeptin]],[[Aplasmomycin]],[[Urauchimycin]],[[Melafix]],[[Narasin]],[[Lactivicin]],[[Lasalocid]],[[Kendomycin]],[[Enediyne]],[[Arenicin]],[[Esperamicin]],[[Echinomycin]],[[Streptazolin]],[[Pristinamycin_IA]],[[Seraticin]],[[Streptogramin_B]],[[Oxacephem]],[[Production_Of_Antibiotics]],[[Dalfopristin]],[[Cruciferous_Vegetables]],[[Spectinomycin]],[[Kanamycin]],[[Cycloserine]],[[Phytoalexin]],[[Gliotoxin]],[[Coumermycin_A1]],[[Arsphenamine]],[[Ethambutol]],[[Clorobiocin]],[[Pyocyanin]],[[Category:Combination_Antibiotics]],[[DB-2073]],[[Myxopyronin]],[[Category:Antibiotic_Resistance]],[[Netropsin]],[[Kedarcidin]],[[Antibiotic_Misuse]],[[Neopluramycin]],[[Neothramycin]],[[Enviomycin]],[[Chartreusin]],[[Landomycin]],[[Xanthomycin_A]],[[Pristinamycin]],[[Maduropeptin]],[[Macromomycin_B]],[[Efflux_(microbiology)]],[[Subtherapeutic_Antibiotic_Use_In_Swine]],[[Citromycin]],[[Thiocarlide]],[[Ambazone]],[[Vulgamycin]],[[Landomycinone]],[[List_Of_Antibiotics]],[[Sparassol]],[[Coprinol]],[[Kidamycin]],[[Bambermycin]],[[Medicinal_Mushroom]],[[Reuterin]],[[Furonazide]],[[MC21-B]],[[Alazopeptin]],[[Aspergillic_Acid]],[[Endiandric_Acid_C]],[[Nonribosomal_Peptide]],[[Tyrocidine]],[[User:Harmonslide/sandbox]],[[Bottromycin]],[[Ceragenin]],[[Puromycin]],[[Triclosan]],[[Amp_Resistance]],[[Pluramycin_A]],[[Resistome]],[[Styelin_A]],[[Surotomycin]],[[Naphthomycin_A]],[[Lipopeptide]],[[Bacteriostatic_Agent]],[[Actaplanin]],[[Actinorhodin]],[[Methylenomycin_A]],[[Friulimicin]],[[Trimethoprim/polymyxin]],[[Monensin]],[[Methylenomycin_B]],[[Vinyldithiin]],[[Isoniazid]],[[Carbomycin]],[[17-Dimethylaminoethylamino-17-demethoxygeldanamycin]],[[Nitrofurantoin]],[[Solithromycin]],[[Antibiotic_Tolerance]],[[Ramoplanin]],[[Antibiotic_Resistance]],[[Macbecin]],[[Linopristin]],[[Zwittermicin_A]],[[Broad-spectrum_Antibiotic]],[[Neosalvarsan]],[[Pulvinone]],[[Bafilomycin]],[[Anthramycin]],[[Geldanamycin]],[[Mupirocin]],[[Trimethoprim]],[[Animal_Drug_Availability_Act_1996]],[[Allistatin]],[[Antibiosis]],[[Topoisomerase_Inhibitor]],[[Thiostrepton]],[[Promin]],[[Telavancin]],[[Dapsone]],[[Multidrug_Tolerance]],[[Solasulfone]],[[Antibiotics]],[[Albomycin]],[[Nifurquinazol]],[[Streptomyces_Isolates]],[[Archaeocin]],[[Nitrofural]],[[Tunicamycin]],[[Surfactin]],[[SmeT]],[[Blasticidin_S]],[[Thioacetazone]],[[Aphidicolin]],[[A23187]],[[Raphanin]],[[Katanosin]],[[Erythromycin/sulfafurazole]],[[Antimicrobial_Pharmacodynamics]],[[Aminocoumarin]],[[Pyocyanase]],[[AGG01]],[[Furazolidone]],[[GSK_299423]],[[Cell_Envelope_Antibiotic]],[[Neocarzinostatin]],[[Nifuroxazide]],[[Prothionamide]],[[Hachimycin]],[[Xibornol]],[[Tanespimycin]],[[Persister_Cell]],[[Avenanthramide]],[[Ristocetin]],[[Lipoglycopeptide]],[[Streptogramin]],[[Fosfomycin]],[[NXL103]],[[Antibiotic_Sensitivity]],[[Clofoctol]],[[Streptolydigin]],[[Polyoxins]],[[Allyl_Isothiocyanate]],[[Roseophilin]],[[Calicheamicin]],[[Taksta]],[[Allicin]],[[Thymineless_Death]],[[Guanacastepene_A]],[[Cathelicidin]],[[Cycloheximide]],[[Herbimycin]],[[Thiolutin]],[[Tobramycin/dexamethasone]],[[Extended-spectrum_Penicillin]],[[Novobiocin]],[[Chromomycin_A3]],[[Ansamycin]],[[Peptaibol]],[[Antimycin_A]],[[Salinosporamide_A]],[[Myriocin]],[[Staurosporine]],[[Category:Cell_Envelope_Antibiotics]],[[(6S)-6-Fluoroshikimic_Acid]],[[Trichostatin_A]],[[Category:Protein_Synthesis_Inhibitor_Antibiotics]],[[Category:Nucleic_Acid_Inhibitor_Antibiotics]],[[Leptomycin]],[[Ascofuranone]],[[Plectasin]],[[Nigericin]],[[Nucleic_Acid_Inhibitor]],[[Clofazimine]],[[Acetic_Acid/hydrocortisone]],[[Medicinal_Molds]],[[Template:Antimycobacterials]],[[Ethionamide]],[[Salinomycin]],
[[Category:Anticoagulants]]	[[Pulvinone]],
[[Category:Antidepressants]]	[[Isoniazid]],
[[Category:Antidotes]]	[[Cruciferous_Vegetables]],
[[Category:Antifungals]]	[[Vinyldithiin]],[[Allicin]],[[Medicinal_Molds]],[[Streptomyces_Isolates]],[[Acetic_Acid/hydrocortisone]],[[Sparassol]],[[Triclosan]],[[Melafix]],
[[Category:Antiinfective_Agent_Stubs]]	[[Category:Antibiotic_Stubs]],
[[Category:Antimalarial_Agents]]	[[Aplasmomycin]],
[[Category:Antimicrobial_Peptides]]	[[Trimethoprim/polymyxin]],[[Peptaibol]],
[[Category:Antineoplastic_Drugs]]	[[Anthramycin]],
[[Category:Antiparasitic_Agents]]	[[Narasin]],[[Lasalocid]],[[Streptomyces_Isolates]],[[Salinomycin]],[[Medicinal_Molds]],
[[Category:Antiprotozoal_Agents]]	[[Furazolidone]],[[Nitrofural]],
[[Category:Antiseptics]]	[[Ambazone]],
[[Category:Antitubercular_Agents]]	[[Ethionamide]],
[[Category:Archaea]]	[[Archaeocin]],
[[Category:Aromatic_Amines]]	[[Trimethoprim]],
[[Category:Aromatic_Ketones]]	[[Trichostatin_A]],
[[Category:Articles_Created_Via_The_Article_Wizard]]	[[Vinyldithiin]],
[[Category:Ascidiacea]]	[[Halocyamine]],
[[Category:Bacteria]]	[[Multidrug_Tolerance]],[[Streptomyces_Isolates]],
[[Category:Bacterial_Dihydrofolate_Reductase_Inhibitors]]	[[Trimethoprim]],
[[Category:Bacterial_Proteins]]	[[SmeT]],
[[Category:Bactericides]]	[[Antibiotics]],[[User:Harmonslide/sandbox]],
[[Category:Bacteriology]]	[[Reuterin]],
[[Category:Benzamides]]	[[Novobiocin]],
[[Category:Benzoazulenes]]	[[Guanacastepene_A]],
[[Category:Benzoic_Acids]]	[[MC21-B]],
[[Category:Benzoxazoles]]	[[A23187]],
[[Category:Biochemistry]]	[[Reuterin]],
[[Category:Biological_Evolution]]	[[Category:Antibiotic_Resistance]],
[[Category:Biological_Interactions]]	[[Antibiosis]],
[[Category:Biological_Pigments]]	[[Pyocyanin]],
[[Category:Biosynthesis]]	[[Pluramycin_A]],
[[Category:Biotechnology]]	[[Medicinal_Mushroom]],[[Streptomyces_Isolates]],[[Medicinal_Molds]],
[[Category:Biphenyls]]	[[MC21-B]],[[MC21-A]],
[[Category:Brassicaceae]]	[[Cruciferous_Vegetables]],
[[Category:Brooklyn_College_Faculty]]	[[Albert_Schatz_(scientist)]],
[[Category:Cancer]]	[[Streptomyces_Isolates]],[[Medicinal_Molds]],[[Medicinal_Mushroom]],
[[Category:Cancer_Deaths_In_Pennsylvania]]	[[Albert_Schatz_(scientist)]],
[[Category:Cancer_Research]]	[[Enediyne]],[[Esperamicin]],[[Calicheamicin]],[[Neocarzinostatin]],
[[Category:Cancer_Treatments]]	[[Pluramycin_A]],
[[Category:Carbamates]]	[[Ansamycin]],[[Geldanamycin]],[[Streptazolin]],[[Novobiocin]],[[Herbimycin]],[[17-Dimethylaminoethylamino-17-demethoxygeldanamycin]],[[Macbecin]],[[Tanespimycin]],
[[Category:Carbohydrate_Chemistry]]	[[Landomycinone]],
[[Category:Carboxylate_Esters]]	[[Mupirocin]],[[Antimycin_A]],
[[Category:Carboxylic_Acids]]	[[Methylenomycin_A]],[[Monensin]],[[(6S)-6-Fluoroshikimic_Acid]],[[Endiandric_Acid_C]],[[Narasin]],[[Salinomycin]],
[[Category:Cell_Death]]	[[Thymineless_Death]],
[[Category:Chemical_Pathology]]	[[Ristocetin]],
[[Category:Chemotherapy]]	[[Streptomyces_Isolates]],[[Medicinal_Molds]],[[Medicinal_Mushroom]],
[[Category:Chromenes]]	[[Glycyrrhizol]],
[[Category:Cleaning_Product_Components]]	[[Surfactin]],
[[Category:Colloidal_Chemistry]]	[[Surfactin]],
[[Category:Combination_Antibiotics]]	[[Pristinamycin]],
[[Category:Combination_Drugs]]	[[Acetic_Acid/hydrocortisone]],[[Tobramycin/dexamethasone]],[[Erythromycin/sulfafurazole]],[[Trimethoprim/polymyxin]],[[Category:Combination_Antibiotics]],
[[Category:Corrosion_Inhibitors]]	[[Hexamethylenetetramine]],
[[Category:Coumarin_Drugs]]	[[Novobiocin]],[[Aminocoumarin]],
[[Category:Cyclic_Peptides]]	[[Pristinamycin]],[[Friulimicin]],[[Etamycin]],[[Gramicidin_S]],[[Daptomycin]],
[[Category:Cyclitols]]	[[(6S)-6-Fluoroshikimic_Acid]],[[Validamycin]],
[[Category:Cycloalkenes]]	[[Methylenomycin_B]],
[[Category:Cycloheptanaphthalenes]]	[[Aphidicolin]],
[[Category:Deaths_From_Pancreatic_Cancer]]	[[Albert_Schatz_(scientist)]],
[[Category:Depsipeptides]]	[[Kettapeptin]],[[Pristinamycin]],[[Katanosin]],[[Streptogramin_B]],[[Beauvericin]],[[Linopristin]],[[Daptomycin]],
[[Category:Dicarboxylic_Acids]]	[[MC21-B]],
[[Category:Dietary_Antioxidants]]	[[Vinyldithiin]],[[Allicin]],
[[Category:Dihydrofolate_Reductase_Inhibitors]]	[[Trimethoprim/polymyxin]],
[[Category:Dihydropteroate_Synthetase_Inhibitors]]	[[Dapsone]],[[Promin]],
[[Category:Diols]]	[[Nifurquinazol]],
[[Category:Diterpenes]]	[[Aphidicolin]],[[Guanacastepene_A]],
[[Category:Drug_Mechanisms]]	[[Thymineless_Death]],
[[Category:Drug_Resistance]]	[[Category:Antibiotic_Resistance]],
[[Category:Drug_Templates_By_ATC]]	[[Template:Antimycobacterials]],
[[Category:Drugs]]	[[Anthramycin]],
[[Category:Eli_Lilly_And_Company]]	[[Daptomycin]],
[[Category:Endocrine_Disruptors]]	[[Triclosan]],
[[Category:Enediynes]]	[[Esperamicin]],[[Calicheamicin]],[[Neocarzinostatin]],[[Enediyne]],
[[Category:Enols]]	[[Pulvinone]],
[[Category:Enzymes]]	[[Nonribosomal_Peptide]],
[[Category:Epoxides]]	[[Fosfomycin]],[[Fosfomycin/tobramycin]],[[Mupirocin]],[[Methylenomycin_A]],
[[Category:Ethers]]	[[Tanespimycin]],[[17-Dimethylaminoethylamino-17-demethoxygeldanamycin]],[[Ansamycin]],[[Geldanamycin]],[[Herbimycin]],
[[Category:Evolutionary_Biology]]	[[Antibiotic_Resistance]],
[[Category:Experimental_Cancer_Drugs]]	[[Salinosporamide_A]],[[Tanespimycin]],
[[Category:Experimental_Cancer_Treatments]]	[[Medicinal_Mushroom]],
[[Category:Experimental_Medical_Treatments]]	[[Medicinal_Mushroom]],
[[Category:Fatty_Acids]]	[[Mupirocin]],
[[Category:Fish_Health]]	[[Melafix]],
[[Category:Food_Additives]]	[[Bambermycin]],
[[Category:Food_Politics]]	[[Subtherapeutic_Antibiotic_Use_In_Swine]],
[[Category:Fuels]]	[[Hexamethylenetetramine]],
[[Category:Functional_Groups]]	[[Enediyne]],
[[Category:Fungicides]]	[[Cycloheximide]],[[Validamycin]],
[[Category:Furans]]	[[Roseophilin]],[[Furonazide]],
[[Category:Furones]]	[[Pulvinone]],
[[Category:Garlic]]	[[Allicin]],[[Allistatin]],[[Vinyldithiin]],
[[Category:Gastroenterology]]	[[Cruciferous_Vegetables]],
[[Category:Genetic_Engineering]]	[[Blasticidin_S]],
[[Category:Genomics]]	[[Resistome]],
[[Category:German_Inventions]]	[[Arsphenamine]],
[[Category:GlaxoSmithKline]]	[[Mupirocin]],
[[Category:Glucocorticoids]]	[[Tobramycin/dexamethasone]],
[[Category:Glucosinolates]]	[[Cruciferous_Vegetables]],
[[Category:Glutarimides]]	[[Cycloheximide]],
[[Category:Glycopeptide_Antibiotics]]	[[Actaplanin]],[[Nonribosomal_Peptide]],
[[Category:Guanidines]]	[[TAN-1057_A]],[[Ambazone]],[[Blasticidin_S]],[[TAN-1057_C]],
[[Category:Health_Disasters]]	[[Antibiotic_Resistance]],[[Category:Antibiotic_Resistance]],[[Antibiotic_Misuse]],
[[Category:Hepatology]]	[[Cruciferous_Vegetables]],
[[Category:Histone_Deacetylase_Inhibitors]]	[[Trichostatin_A]],
[[Category:History_Books_About_Medicine]]	[[The_Demon_Under_The_Microscope]],
[[Category:History_Of_Medicine]]	[[Pyocyanase]],
[[Category:Hydantoins]]	[[Nitrofurantoin]],
[[Category:Hydrazides]]	[[Isoniazid]],[[Nifuroxazide]],[[Furonazide]],
[[Category:Hydrazones]]	[[Furazolidone]],
[[Category:Hydroxamic_Acids]]	[[Trichostatin_A]],
[[Category:Hydroxy_Acids]]	[[Myriocin]],
[[Category:Imidazoles]]	[[Netropsin]],[[Clorobiocin]],[[Coumermycin_A1]],
[[Category:Immune_System]]	[[Cathelicidin]],
[[Category:Immunosuppressants]]	[[Gliotoxin]],[[Streptomyces_Isolates]],[[Medicinal_Molds]],
[[Category:Indoles]]	[[Gliotoxin]],[[Cruciferous_Vegetables]],
[[Category:Indolocarbazoles]]	[[Staurosporine]],
[[Category:Infectious_Diseases]]	[[Multidrug_Tolerance]],
[[Category:Insecticides]]	[[Allyl_Isothiocyanate]],
[[Category:Ionophores]]	[[Nigericin]],[[A23187]],[[Salinomycin]],[[Beauvericin]],[[Monensin]],
[[Category:Isobutyrates]]	[[Antimycin_A]],
[[Category:Isonicotinamides]]	[[Isoniazid]],[[Furonazide]],[[Pristinamycin_IA]],
[[Category:Isothiocyanates]]	[[Raphanin]],[[Cruciferous_Vegetables]],[[Allyl_Isothiocyanate]],
[[Category:Isoxazolidinones]]	[[Cycloserine]],
[[Category:Ketolide_Antibiotics]]	[[Solithromycin]],
[[Category:Ketones]]	[[Cycloheximide]],[[Lasalocid]],[[Narasin]],[[Salinomycin]],[[Pyocyanin]],[[Methylenomycin_A]],[[Methylenomycin_B]],[[Guanacastepene_A]],[[Ascofuranone]],
[[Category:Lactams]]	[[Geldanamycin]],[[Salinosporamide_A]],[[TAN-1057_C]],[[Thiolutin]],[[Cycloserine]],[[Tanespimycin]],[[Herbimycin]],[[17-Dimethylaminoethylamino-17-demethoxygeldanamycin]],[[Ansamycin]],[[Gliotoxin]],[[Staurosporine]],
[[Category:Lactones]]	[[Antimycin_A]],[[Salinosporamide_A]],
[[Category:Leprosy]]	[[Solasulfone]],[[Dapsone]],[[Promin]],
[[Category:Leukocytes]]	[[Cathelicidin]],
[[Category:Lipopeptides]]	[[Surfactin]],[[Friulimicin]],[[Daptomycin]],[[Lipopeptide]],
[[Category:Macrocycles]]	[[17-Dimethylaminoethylamino-17-demethoxygeldanamycin]],
[[Category:Macrolide_Antibiotics]]	[[Solithromycin]],
[[Category:Macrolides]]	[[Solithromycin]],[[Kendomycin]],
[[Category:Medicinal_Fungi]]	[[Medicinal_Molds]],[[Medicinal_Mushroom]],
[[Category:Medicine]]	[[Streptomyces_Isolates]],[[Medicinal_Molds]],
[[Category:Membrane_Biology]]	[[Efflux_(microbiology)]],
[[Category:Microbiologists]]	[[Albert_Schatz_(scientist)]],
[[Category:Microbiology_Organisations]]	[[Alliance_For_The_Prudent_Use_Of_Antibiotics]],
[[Category:Milk]]	[[Delvotest]],
[[Category:Molecular_Biology]]	[[Nonribosomal_Peptide]],
[[Category:Monoamine_Oxidase_Inhibitors]]	[[Furazolidone]],
[[Category:Mycotoxins]]	[[Beauvericin]],[[Pyrenocine]],[[Gliotoxin]],
[[Category:NMDA_Receptor_Agonists]]	[[Cycloserine]],
[[Category:Naphthoquinones]]	[[Naphthomycin_A]],
[[Category:Natural_Phenols]]	[[Ascofuranone]],[[Actinorhodin]],
[[Category:Neurophysiology]]	[[Bafilomycin]],
[[Category:Nitriles]]	[[GSK_299423]],
[[Category:Nitrofurans]]	[[Nitrofural]],[[Nifuroxazide]],[[Nitrofurantoin]],[[Furazolidone]],[[Nifurquinazol]],
[[Category:Nitrogen_Heterocycles]]	[[Hexamethylenetetramine]],
[[Category:Nucleic_Acids]]	[[Pluramycin_A]],
[[Category:Oats]]	[[Avenanthramide]],
[[Category:Oligosaccharides]]	[[Validamycin]],
[[Category:Oncology]]	[[Cruciferous_Vegetables]],
[[Category:Organic_Acids]]	[[Aspergillic_Acid]],
[[Category:Organic_Disulfides]]	[[Thiolutin]],
[[Category:Organoarsenic_Compounds]]	[[Neosalvarsan]],[[Arsphenamine]],
[[Category:Organobromides]]	[[MC21-A]],[[MC21-B]],
[[Category:Organochlorides]]	[[Clofazimine]],[[Triclosan]],[[Roseophilin]],[[Clofoctol]],[[Ascofuranone]],
[[Category:Organofluorides]]	[[(6S)-6-Fluoroshikimic_Acid]],
[[Category:Organosulfates]]	[[Avibactam]],
[[Category:Organosulfur_Compounds]]	[[Allistatin]],
[[Category:Orphan_Drugs]]	[[Clofazimine]],
[[Category:Otologicals]]	[[Nitrofural]],
[[Category:Oxazoles]]	[[Dalfopristin]],
[[Category:Oxazolidinones]]	[[Furazolidone]],
[[Category:Oxidoreductase_Inhibitors]]	[[Fosmidomycin]],
[[Category:Oxygen_Heterocycles]]	[[Methylenomycin_A]],
[[Category:Penicillium]]	[[Questiomycin_A]],
[[Category:People_From_Connecticut]]	[[Albert_Schatz_(scientist)]],
[[Category:People_From_Norwich,_Connecticut]]	[[Albert_Schatz_(scientist)]],
[[Category:Peptides]]	[[User:Harmonslide/sandbox]],[[Bottromycin]],[[Halocyamine]],[[Pristinamycin_IA]],[[Netropsin]],[[Thiostrepton]],[[Plectasin]],[[Nonribosomal_Peptide]],
[[Category:Peripheral_Membrane_Proteins]]	[[Daptomycin]],
[[Category:Pharmaceuticals_Policy]]	[[Antibiotic_Resistance]],[[Antibiotic_Misuse]],[[Category:Antibiotic_Resistance]],
[[Category:Pharmacodynamics]]	[[Antimicrobial_Pharmacodynamics]],
[[Category:Pharmacology]]	[[Melafix]],
[[Category:Phenazines]]	[[Clofazimine]],[[Pyocyanin]],
[[Category:Phenol_Ethers]]	[[Trimethoprim]],[[Triclosan]],[[Thiocarlide]],[[GSK_299423]],[[Geldanamycin]],[[Trimethoprim/polymyxin]],[[Roseophilin]],
[[Category:Phenols]]	[[Arsphenamine]],[[Xibornol]],[[Nifuroxazide]],[[Clofoctol]],[[Neosalvarsan]],
[[Category:Phosphonic_Acids]]	[[Fosfomycin/tobramycin]],[[Fosmidomycin]],[[Fosfomycin]],
[[Category:Phytoalexins]]	[[Avenanthramide]],[[Phytoalexin]],
[[Category:Phytochemicals]]	[[Vinyldithiin]],
[[Category:Pig_Farming]]	[[Subtherapeutic_Antibiotic_Use_In_Swine]],
[[Category:Pigments]]	[[Naphthomycin_A]],
[[Category:Piperidines]]	[[GSK_299423]],
[[Category:Polycyclic_Organic_Compounds]]	[[Hexamethylenetetramine]],
[[Category:Polyketide_Antibiotics]]	[[Calicheamicin]],
[[Category:Polymyxin_Antibiotics]]	[[Trimethoprim/polymyxin]],
[[Category:Polyphenols]]	[[MC21-A]],
[[Category:Preservatives]]	[[Hexamethylenetetramine]],
[[Category:Prodrugs]]	[[Isoniazid]],
[[Category:Propionamides]]	[[Streptolydigin]],
[[Category:Proteasome_Inhibitors]]	[[Salinosporamide_A]],
[[Category:Protein_Kinase_Inhibitors]]	[[Staurosporine]],
[[Category:Proteins]]	[[Hydramacin-1]],
[[Category:Protozoal_Dihydrofolate_Reductase_Inhibitors]]	[[Trimethoprim]],
[[Category:Pterocarpans]]	[[Glycyrrhizol]],
[[Category:Pungent_Flavors]]	[[Allicin]],[[Vinyldithiin]],[[Allistatin]],[[Allyl_Isothiocyanate]],
[[Category:Pyridines]]	[[Ethionamide]],[[Prothionamide]],
[[Category:Pyrimidines]]	[[Trimethoprim]],[[Trimethoprim/polymyxin]],
[[Category:Pyrimidones]]	[[TAN-1057_A]],[[Blasticidin_S]],
[[Category:Pyrones]]	[[Citromycin]],[[Spectinomycin]],
[[Category:Pyrroles]]	[[Roseophilin]],[[A23187]],
[[Category:Pyrrolidones]]	[[Streptolydigin]],
[[Category:Quinazolines]]	[[Nifurquinazol]],
[[Category:Quinolines]]	[[GSK_299423]],
[[Category:Quinone_Methides]]	[[Kendomycin]],
[[Category:Quinones]]	[[Ansamycin]],[[Actinorhodin]],[[17-Dimethylaminoethylamino-17-demethoxygeldanamycin]],[[Tanespimycin]],[[Macbecin]],[[Geldanamycin]],[[Herbimycin]],
[[Category:Quinoxalines]]	[[Echinomycin]],
[[Category:Reagents_For_Organic_Chemistry]]	[[Hexamethylenetetramine]],
[[Category:Russian_Inventions]]	[[Gramicidin_S]],
[[Category:Rutgers_University_Alumni]]	[[Albert_Schatz_(scientist)]],
[[Category:Salicylamides]]	[[Antimycin_A]],
[[Category:Salicylic_Acids]]	[[4-Aminosalicylic_Acid]],[[Lasalocid]],[[Platensimycin]],
[[Category:Semicarbazones]]	[[Nitrofural]],
[[Category:Soil_Scientists]]	[[Albert_Schatz_(scientist)]],
[[Category:Spiro_Compounds]]	[[Narasin]],[[Streptolydigin]],
[[Category:Steroids]]	[[Ceragenin]],[[Fusidic_Acid]],
[[Category:Streptomyces]]	[[Streptomyces_Isolates]],[[Bottromycin]],
[[Category:Sulfinates]]	[[Neosalvarsan]],
[[Category:Sulfonates]]	[[Solasulfone]],
[[Category:Sulfones]]	[[Solasulfone]],[[Dapsone]],[[Promin]],
[[Category:Sulfoxides]]	[[Vinyldithiin]],
[[Category:Surfactants]]	[[Surfactin]],
[[Category:Syphilis]]	[[Arsphenamine]],
[[Category:Temple_University_Faculty]]	[[Albert_Schatz_(scientist)]],
[[Category:Terpenes_And_Terpenoids]]	[[Ascofuranone]],
[[Category:Tetrahydrofurans]]	[[Narasin]],[[Lasalocid]],[[Ascofuranone]],[[Salinomycin]],
[[Category:Tetrahydropyrans]]	[[Salinomycin]],[[Lasalocid]],[[Narasin]],
[[Category:Thiazoles]]	[[Bottromycin]],
[[Category:Thioamides]]	[[Prothionamide]],
[[Category:Thiosulfinates]]	[[Vinyldithiin]],[[Allicin]],
[[Category:Thioureas]]	[[Thiocarlide]],[[Ambazone]],[[Thioacetazone]],
[[Category:Topoisomerase_Inhibitors]]	[[Topoisomerase_Inhibitor]],
[[Category:Toxicology]]	[[Antimycin_A]],
[[Category:Transferase_Inhibitors]]	[[Aphidicolin]],
[[Category:Triazoles]]	[[Solithromycin]],
[[Category:Trichoderma]]	[[Peptaibol]],
[[Category:Tuberculosis]]	[[4-Aminosalicylic_Acid]],[[Isoniazid]],[[Thioacetazone]],[[Ethambutol]],[[Cycloserine]],
[[Category:United_States_Federal_Health_Legislation]]	[[Animal_Drug_Availability_Act_1996]],
[[Category:Unnecessary_Health_Care]]	[[Antibiotic_Misuse]],
[[Category:Ureas]]	[[TAN-1057_A]],
[[Category:Vegetables]]	[[Cruciferous_Vegetables]],
[[Category:Veterinary_Medicine]]	[[Animal_Drug_Availability_Act_1996]],[[Antibiotic_Resistance]],[[Antibiotic_Misuse]],
[[Category:Vitamin_D]]	[[Cathelicidin]],
[[Category:World_Health_Organization_Essential_Medicines]]	[[Trimethoprim]],[[Dapsone]],[[Nitrofurantoin]],[[Clofazimine]],[[Spectinomycin]],[[Isoniazid]],[[Cycloserine]],[[Kanamycin]],[[Ethambutol]],[[Ethionamide]],[[4-Aminosalicylic_Acid]],
[[Catfish]]	[[Antimycin_A]],
[[Catheter]]	[[Multidrug_Tolerance]],
[[Cation]]	[[Monensin]],[[Surfactin]],
[[Cationic]]	[[AGG01]],
[[Cauliflower]]	[[Cruciferous_Vegetables]],[[Cruciferous_Vegetables]],
[[Cedax]]	[[List_Of_Antibiotics]],
[[Cefaclor]]	[[List_Of_Antibiotics]],
[[Cefadroxil]]	[[List_Of_Antibiotics]],
[[Cefalexin]]	[[List_Of_Antibiotics]],
[[Cefalothin]]	[[List_Of_Antibiotics]],
[[Cefalotin]]	[[List_Of_Antibiotics]],
[[Cefamandole]]	[[List_Of_Antibiotics]],
[[Cefazolin]]	[[List_Of_Antibiotics]],
[[Cefdinir]]	[[List_Of_Antibiotics]],
[[Cefditoren]]	[[List_Of_Antibiotics]],
[[Cefepime]]	[[List_Of_Antibiotics]],
[[Cefixime]]	[[List_Of_Antibiotics]],
[[Cefmenoxime]]	[[Antibiotics]],
[[Cefobid]]	[[List_Of_Antibiotics]],
[[Cefoperazone]]	[[Antibiotics]],[[List_Of_Antibiotics]],
[[Cefotaxime]]	[[List_Of_Antibiotics]],
[[Cefoxitin]]	[[Antibiotic_Resistance]],[[List_Of_Antibiotics]],
[[Cefpodoxime]]	[[List_Of_Antibiotics]],
[[Cefprozil]]	[[List_Of_Antibiotics]],
[[Ceftaroline]]	[[Antibiotics]],
[[Ceftaroline_Fosamil]]	[[List_Of_Antibiotics]],
[[Ceftazidime]]	[[Antibiotics]],[[List_Of_Antibiotics]],
[[Ceftibuten]]	[[List_Of_Antibiotics]],
[[Ceftin]]	[[List_Of_Antibiotics]],
[[Ceftizoxime]]	[[List_Of_Antibiotics]],
[[Ceftobiprole]]	[[List_Of_Antibiotics]],
[[Ceftriaxone]]	[[List_Of_Antibiotics]],
[[Cefuroxime]]	[[List_Of_Antibiotics]],
[[Cefzil]]	[[List_Of_Antibiotics]],
[[Cell_(biology)]]	[[A23187]],[[Phytoalexin]],[[Streptolydigin]],
[[Cell_(journal)]]	[[Antibiotic_Resistance]],
[[Cell_Culture]]	[[Ascofuranone]],
[[Cell_Cycle]]	[[Trichostatin_A]],[[Tunicamycin]],[[Topoisomerase_Inhibitor]],
[[Cell_Envelope]]	[[Cell_Envelope_Antibiotic]],
[[Cell_Envelope_Antibiotic]]	[[Trimethoprim/polymyxin]],[[Template:Antimycobacterials]],
[[Cell_Lysis]]	[[Arenicin]],
[[Cell_Membrane]]	[[A23187]],[[Gramicidin_S]],[[Hitachimycin]],[[Daptomycin]],[[Beauvericin]],[[Gliotoxin]],[[Peptaibol]],[[Triclosan]],[[Surfactin]],
[[Cell_Membranes]]	[[Platensimycin]],
[[Cell_Wall]]	[[Ethambutol]],[[Katanosin]],[[List_Of_Antibiotics]],[[List_Of_Antibiotics]],[[List_Of_Antibiotics]],[[List_Of_Antibiotics]],[[Phytoalexin]],[[List_Of_Antibiotics]],[[List_Of_Antibiotics]],[[Telavancin]],[[List_Of_Antibiotics]],[[Ramoplanin]],[[List_Of_Antibiotics]],[[List_Of_Antibiotics]],[[List_Of_Antibiotics]],
[[Cellular_Membrane]]	[[Gramicidin_S]],
[[Cenovis]]	[[Medicinal_Molds]],[[Medicinal_Mushroom]],
[[Center_For_Veterinary_Medicine]]	[[Animal_Drug_Availability_Act_1996]],
[[Centers_For_Disease_Control_And_Prevention]]	[[Antibiotic_Resistance]],[[Antibiotics]],[[Antibiotics]],[[Antibiotic_Resistance]],[[Antibiotics]],[[Antibiotic_Misuse]],[[Alliance_For_The_Prudent_Use_Of_Antibiotics]],
[[Central_Nervous_System]]	[[List_Of_Antibiotics]],[[Isoniazid]],[[Antibiotic_Misuse]],
[[Cephalexin]]	[[Nitrofurantoin]],
[[Cephalosporin]]	[[Antibiotic_Resistance]],[[List_Of_Antibiotics]],[[List_Of_Antibiotics]],[[List_Of_Antibiotics]],[[Medicinal_Mushroom]],[[Antibiotics]],[[List_Of_Antibiotics]],[[Antibiotics]],[[List_Of_Antibiotics]],[[Antibiotics]],[[Medicinal_Molds]],
[[Cephamandole]]	[[Antibiotics]],
[[Cephem]]	[[Oxacephem]],
[[Cerebrospinal_Fluid]]	[[Isoniazid]],
[[Cerulenin]]	[[Medicinal_Molds]],
[[Chandigarh]]	[[Surfactin]],
[[Chelation]]	[[Kedarcidin]],[[Aspergillic_Acid]],
[[Chelation_Therapy]]	[[4-Aminosalicylic_Acid]],
[[Chemical_Bond]]	[[Nonribosomal_Peptide]],
[[Chemical_Compound]]	[[Aspergillic_Acid]],[[Endiandric_Acid_C]],
[[Chemical_Polarity]]	[[Platensimycin]],
[[Chemical_Reaction]]	[[Endiandric_Acid_C]],
[[Chemical_Research_In_Toxicology]]	[[Topoisomerase_Inhibitor]],
[[Chemical_Structure]]	[[Surfactin]],
[[Chemical_Synthesis]]	[[Antibiotics]],[[Kedarcidin]],
[[Chemically_Induced_Dimerization]]	[[Coumermycin_A1]],
[[Chemotherapeutic]]	[[Neosalvarsan]],
[[Chemotherapy]]	[[Macbecin]],[[Trimethoprim]],[[Arsphenamine]],
[[Chen_Hongshou]]	[[Medicinal_Mushroom]],
[[Chile]]	[[Endiandric_Acid_C]],
[[Chili_Pepper]]	[[Allyl_Isothiocyanate]],[[Allicin]],
[[Chills]]	[[Spectinomycin]],
[[China]]	[[Nitrofurantoin]],
[[Chinese_Cabbage]]	[[Cruciferous_Vegetables]],
[[Chirality_(chemistry)]]	[[Allicin]],
[[Chiron_Corporation]]	[[Daptomycin]],
[[Chitin]]	[[Medicinal_Mushroom]],[[Polyoxins]],
[[Chitosan]]	[[Medicinal_Mushroom]],
[[Chlamydia_Infection]]	[[List_Of_Antibiotics]],
[[Chloramphenicol]]	[[SmeT]],[[Antibiotic_Resistance]],[[Broad-spectrum_Antibiotic]],[[Bacteriostatic_Agent]],[[List_Of_Antibiotics]],[[Bottromycin]],[[Streptomyces_Isolates]],
[[Chlorhexidine_Gluconate]]	[[Triclosan]],[[Triclosan]],
[[Chlorinated]]	[[Triclosan]],
[[Chlorine]]	[[Triclosan]],[[Triclosan]],
[[Chloroform]]	[[Triclosan]],[[Triclosan]],
[[Chlorogenic_Acid]]	[[Medicinal_Molds]],
[[Chloromycetin]]	[[List_Of_Antibiotics]],
[[Chloroxylenol]]	[[Triclosan]],
[[Cholera]]	[[Furazolidone]],[[List_Of_Antibiotics]],[[Pyocyanase]],
[[Cholestatic_Jaundice]]	[[Dapsone]],
[[Cholesterol]]	[[Vinyldithiin]],
[[Choosing_Wisely]]	[[Antibiotic_Misuse]],[[Antibiotic_Misuse]],[[Antibiotic_Misuse]],[[Antibiotic_Misuse]],[[Antibiotic_Misuse]],[[Antibiotic_Misuse]],[[Antibiotic_Misuse]],
[[Chorismate_Synthase]]	[[(6S)-6-Fluoroshikimic_Acid]],
[[Chorismic_Acid]]	[[Pyocyanin]],
[[Chromatin]]	[[Trichostatin_A]],
[[Chromatography]]	[[Guanacastepene_A]],
[[Chromophore]]	[[Kedarcidin]],[[Neocarzinostatin]],
[[Chromoprotein]]	[[Neocarzinostatin]],[[Kedarcidin]],[[Enediyne]],[[Esperamicin]],
[[Chromosome]]	[[Resistome]],[[Fosfomycin]],[[Efflux_(microbiology)]],[[Medicinal_Molds]],
[[Chromosomes]]	[[Antibiotic_Resistance]],
[[Chronic_Disease]]	[[Antibiotics]],
[[Chronic_Wound]]	[[Multidrug_Tolerance]],
[[Chrysin]]	[[Medicinal_Mushroom]],[[Efflux_(microbiology)]],
[[Chymotrypsin]]	[[Gliotoxin]],
[[Ciclosporin]]	[[Medicinal_Molds]],[[Medicinal_Mushroom]],[[Medicinal_Mushroom]],[[Myriocin]],[[Nonribosomal_Peptide]],[[Nonribosomal_Peptide]],
[[Cilastatin]]	[[List_Of_Antibiotics]],
[[Cinnamic_Acid]]	[[Medicinal_Mushroom]],[[Avenanthramide]],
[[Cipro]]	[[List_Of_Antibiotics]],
[[Ciprofloxacin]]	[[Topoisomerase_Inhibitor]],[[List_Of_Antibiotics]],[[Antibiotic_Misuse]],
[[Ciproxin]]	[[List_Of_Antibiotics]],
[[Circumstantial_Evidence]]	[[Antibiotic_Resistance]],
[[Citric_Acid]]	[[Medicinal_Molds]],
[[Citrobacter]]	[[Nitrofurantoin]],
[[Citrobacter_Freundii]]	[[Trimethoprim]],
[[Citromycin]]	[[Medicinal_Molds]],
[[Claforan]]	[[List_Of_Antibiotics]],
[[Clarithromycin]]	[[Solithromycin]],[[List_Of_Antibiotics]],
[[Clavaric_Acid]]	[[Medicinal_Mushroom]],
[[Clavulanate]]	[[Extended-spectrum_Penicillin]],
[[Clavulanic_Acid]]	[[Streptomyces_Isolates]],[[Antibiotics]],
[[Cleft_Lip]]	[[Nitrofurantoin]],
[[Cleft_Palate]]	[[Nitrofurantoin]],
[[Cleocin]]	[[List_Of_Antibiotics]],
[[Clindamycin]]	[[List_Of_Antibiotics]],[[Fosmidomycin]],[[Antibiotic_Resistance]],[[Antibiotic_Resistance]],[[Bacteriostatic_Agent]],[[Antibiotic_Resistance]],
[[Clinical_Trial]]	[[Platensimycin]],[[Daptomycin]],[[Myxopyronin]],[[Tanespimycin]],[[Salinosporamide_A]],[[Solithromycin]],[[Novobiocin]],
[[Clofazimine]]	[[Promin]],[[List_Of_Antibiotics]],[[Template:Antimycobacterials]],[[Dapsone]],
[[Clorobiocin]]	[[Aminocoumarin]],
[[Clostridium]]	[[Lipoglycopeptide]],[[Antibiotic_Resistance]],
[[Clostridium_Difficile]]	[[Ramoplanin]],[[Antibiotics]],[[Antibiotic_Resistance]],[[Antibiotic_Resistance]],[[Broad-spectrum_Antibiotic]],[[Antibiotic_Resistance]],[[Surotomycin]],
[[Clostridium_Perfringens]]	[[Furazolidone]],
[[Cloxacillin]]	[[List_Of_Antibiotics]],
[[Cnidaria]]	[[Hydramacin-1]],[[Hydramacin-1]],
[[Cnidocyte]]	[[Hydramacin-1]],
[[Coagulase_Negative_Staphylococci]]	[[Nitrofurantoin]],
[[Cocaine]]	[[Cycloserine]],[[Cycloserine]],
[[Coccidiosis]]	[[Monensin]],
[[Coccidiostat]]	[[Salinomycin]],[[Salinomycin]],[[Lasalocid]],[[Narasin]],
[[Coccus]]	[[Antibiotics]],[[The_Demon_Under_The_Microscope]],
[[Cochliobolus]]	[[Nonribosomal_Peptide]],[[Nonribosomal_Peptide]],
[[Codinaeopsin]]	[[Medicinal_Molds]],
[[Codons]]	[[Nonribosomal_Peptide]],
[[Coenzyme_B12]]	[[Reuterin]],
[[Cognitive_Behavior_Therapy]]	[[Cycloserine]],
[[Cohort_Study]]	[[Nitrofurantoin]],
[[Colistin]]	[[List_Of_Antibiotics]],
[[Colitis]]	[[Nifuroxazide]],
[[Collard_Greens]]	[[Cruciferous_Vegetables]],
[[Colletotrichum]]	[[Phytoalexin]],
[[Colletotrichum_Gloesporioides]]	[[Phytoalexin]],
[[Colorado]]	[[Animal_Drug_Availability_Act_1996]],[[Antibiotic_Resistance]],
[[Coma]]	[[Cycloserine]],
[[Combination_Drug]]	[[Erythromycin/sulfafurazole]],
[[Commensalism]]	[[Nonribosomal_Peptide]],
[[Committed_Step]]	[[Fosfomycin]],
[[Common_Cold]]	[[Antibiotic_Resistance]],[[Antibiotics]],
[[Competitive_Inhibitor]]	[[List_Of_Antibiotics]],
[[Complicated_Skin_And_Skin_Structure_Infection]]	[[Lipoglycopeptide]],[[Telavancin]],
[[Condensation]]	[[Nonribosomal_Peptide]],[[Nonribosomal_Peptide]],[[Endiandric_Acid_C]],
[[Condensation_Domain]]	[[Daptomycin]],[[Streptogramin_B]],
[[Condensation_Reaction]]	[[Platensimycin]],
[[Conditioned_Response]]	[[Cycloserine]],
[[Conditioned_Stimulus]]	[[Cycloserine]],
[[Confusion]]	[[Antibiotic_Misuse]],
[[Conjunctivitis]]	[[Trimethoprim/polymyxin]],[[Antibiotic_Misuse]],[[Tobramycin/dexamethasone]],
[[Conscription_In_The_United_States]]	[[Albert_Schatz_(scientist)]],
[[Consumer_Reports]]	[[Antibiotic_Misuse]],[[Antibiotic_Misuse]],
[[Continental_Pharma]]	[[Thiocarlide]],
[[Contraceptive_Pill]]	[[Antibiotics]],
[[Convulsions]]	[[Cycloserine]],
[[Copolymer]]	[[Vinyldithiin]],
[[Copper_Chromite]]	[[Aspergillic_Acid]],
[[Coprinol]]	[[Medicinal_Mushroom]],
[[Coprinopsis_Atramentaria]]	[[Medicinal_Mushroom]],
[[Coprinus]]	[[Coprinol]],
[[Coral]]	[[Hydramacin-1]],
[[Cordycepin]]	[[Medicinal_Mushroom]],[[Medicinal_Mushroom]],[[Medicinal_Mushroom]],
[[Cornea]]	[[Tobramycin/dexamethasone]],
[[Corticosteroid]]	[[Antibiotics]],[[Fusidic_Acid]],[[Tobramycin/dexamethasone]],[[Dapsone]],
[[Corylus]]	[[Medicinal_Molds]],
[[Corynebacterium]]	[[User:Harmonslide/sandbox]],[[Fusidic_Acid]],[[Streptomyces_Isolates]],[[Daptomycin]],
[[Corynebacterium_Jeikeium]]	[[Trimethoprim]],
[[Corynebacterium_Pyogenes]]	[[Furazolidone]],
[[Costa_Rica]]	[[Guanacastepene_A]],
[[Coumermycin]]	[[Aminocoumarin]],
[[Covalent_Bond]]	[[Neocarzinostatin]],
[[Cow]]	[[Animal_Drug_Availability_Act_1996]],
[[Craniosynostosis]]	[[Nitrofurantoin]],
[[Craving_(withdrawal)]]	[[Cycloserine]],
[[Cream_(pharmaceutical)]]	[[List_Of_Antibiotics]],[[Fusidic_Acid]],
[[Creatine_Kinase]]	[[Daptomycin]],[[Daptomycin]],
[[Creatinine]]	[[Trimethoprim]],
[[Creatinine_Clearance]]	[[Nitrofurantoin]],
[[Cress]]	[[Cruciferous_Vegetables]],
[[Cross]]	[[Cruciferous_Vegetables]],
[[Crosslinking_Of_DNA]]	[[Furazolidone]],
[[Crown_Ether]]	[[Hexamethylenetetramine]],[[Monensin]],
[[Cryptand]]	[[Hexamethylenetetramine]],
[[Crystal]]	[[Hexamethylenetetramine]],[[Production_Of_Antibiotics]],[[Clofazimine]],
[[Crystal_Structure]]	[[Platensimycin]],
[[Crystalline]]	[[Aspergillic_Acid]],
[[Cubicin]]	[[List_Of_Antibiotics]],
[[Cubist_Pharmaceuticals]]	[[Daptomycin]],[[Daptomycin]],
[[Cultivar]]	[[Cruciferous_Vegetables]],
[[Cultivar_Group]]	[[Cruciferous_Vegetables]],
[[Cyanobacteria]]	[[Nonribosomal_Peptide]],[[Nonribosomal_Peptide]],
[[Cyanophycin]]	[[Nonribosomal_Peptide]],
[[Cyanotoxin]]	[[Nonribosomal_Peptide]],
[[Cyathus_Stercoreus]]	[[Medicinal_Mushroom]],
[[Cyathus_Striatus]]	[[Medicinal_Mushroom]],
[[Cyclic_Compound]]	[[Arsphenamine]],[[Hitachimycin]],[[Surfactin]],[[Nonribosomal_Peptide]],[[Platensimycin]],
[[Cyclic_Peptide]]	[[Pristinamycin_IA]],[[Etamycin]],
[[Cyclization]]	[[Nonribosomal_Peptide]],
[[Cycloaddition]]	[[Endiandric_Acid_C]],
[[Cyclodecapeptide]]	[[Gramicidin_S]],
[[Cyclooxygenase_2]]	[[Medicinal_Mushroom]],
[[Cycloserine]]	[[Cell_Envelope_Antibiotic]],[[List_Of_Antibiotics]],[[Template:Antimycobacterials]],
[[Cyclosporine]]	[[Dalfopristin]],
[[Cystatin]]	[[Cathelicidin]],
[[Cysteine]]	[[Leptomycin]],[[User:Harmonslide/sandbox]],[[Platensimycin]],[[Nonribosomal_Peptide]],[[Fosfomycin]],
[[Cystic_Fibrosis]]	[[Antibiotic_Misuse]],[[Multidrug_Tolerance]],[[Fosfomycin]],[[Fosfomycin/tobramycin]],[[Fosfomycin/tobramycin]],[[Pyocyanin]],[[Pyocyanin]],
[[Cystic_Fibrosis_Transmembrane_Conductance_Regulator]]	[[Pyocyanin]],
[[Cystine]]	[[Raphanin]],
[[Cystitis]]	[[List_Of_Antibiotics]],[[Nitrofurantoin]],
[[Cytochalasin_E]]	[[Medicinal_Molds]],
[[Cytochrome_P450]]	[[Mupirocin]],[[Dalfopristin]],
[[Cytokine]]	[[Antibiotic_Resistance]],
[[Cytokines]]	[[Pyocyanin]],
[[Cytophaga]]	[[Katanosin]],
[[Cytoplasm]]	[[Triclosan]],
[[Cytoplasmic_Membrane]]	[[List_Of_Antibiotics]],[[Efflux_(microbiology)]],
[[Cytosolic]]	[[Cycloserine]],
[[Cytostatic]]	[[Nonribosomal_Peptide]],[[Nonribosomal_Peptide]],
[[Cytotoxic]]	[[MC21-B]],
[[Cytotoxicity]]	[[Pulvinone]],
[[DNA]]	[[List_Of_Antibiotics]],[[Nucleic_Acid_Inhibitor]],[[Bacteriostatic_Agent]],[[Arenicin]],[[Daptomycin]],[[Nitrofurantoin]],[[Mupirocin]],[[Netropsin]],[[Trichostatin_A]],[[Aphidicolin]],[[Raphanin]],[[Topoisomerase_Inhibitor]],[[Phytoalexin]],[[Blasticidin_S]],[[List_Of_Antibiotics]],[[Neocarzinostatin]],
[[DNA_Damage]]	[[Cycloheximide]],
[[DNA_Gyrase]]	[[Nucleic_Acid_Inhibitor]],[[Aminocoumarin]],[[GSK_299423]],[[Antibiotic_Resistance]],[[Aminocoumarin]],[[Aminocoumarin]],[[List_Of_Antibiotics]],[[Antibiotic_Resistance]],[[Aminocoumarin]],[[Novobiocin]],
[[DNA_Ligase]]	[[Topoisomerase_Inhibitor]],
[[DNA_Polymerase]]	[[Aphidicolin]],
[[DNA_Replication]]	[[Thymineless_Death]],
[[DXP_Reductoisomerase]]	[[Fosmidomycin]],[[Fosmidomycin]],
[[Dactinomycin]]	[[Streptomyces_Isolates]],
[[Daedalea_Quercina]]	[[Medicinal_Mushroom]],[[Medicinal_Mushroom]],
[[Daiichi_Sankyo]]	[[Medicinal_Mushroom]],
[[Daikon]]	[[Cruciferous_Vegetables]],
[[Dalbavancin]]	[[Lipoglycopeptide]],[[Lipoglycopeptide]],
[[Dalfopristin]]	[[Streptogramin_B]],[[Quinupristin]],
[[Daniel_Bovet]]	[[Dapsone]],
[[Danielone]]	[[Phytoalexin]],
[[Danish_Veterinary_Institute]]	[[Alliance_For_The_Prudent_Use_Of_Antibiotics]],
[[Daphnopsis_Americana]]	[[Guanacastepene_A]],
[[Dapsone]]	[[Promin]],[[Antibiotics]],[[Template:Antimycobacterials]],[[List_Of_Antibiotics]],[[Clofazimine]],[[Clofazimine]],
[[Daptomycin]]	[[Streptomyces_Isolates]],[[Nonribosomal_Peptide]],[[Lipopeptide]],[[List_Of_Antibiotics]],[[Antibiotics]],
[[Darwinian_Evolution]]	[[Animal_Drug_Availability_Act_1996]],
[[Daunorubicin]]	[[Topoisomerase_Inhibitor]],[[Streptomyces_Isolates]],
[[Deaminase]]	[[Blasticidin_S]],
[[Decarboxylation]]	[[4-Aminosalicylic_Acid]],[[Staurosporine]],[[Platensimycin]],
[[Defensin]]	[[Plectasin]],[[Brilacidin]],
[[Dehydratase]]	[[Mupirocin]],
[[Dehydration_Reaction]]	[[Kedarcidin]],
[[Dehydroalanine]]	[[Nonribosomal_Peptide]],
[[Dehydrogenase]]	[[Endiandric_Acid_C]],
[[Delamanid]]	[[Template:Antimycobacterials]],
[[Delepine_Reaction]]	[[Hexamethylenetetramine]],
[[Demeclocycline]]	[[List_Of_Antibiotics]],
[[Denatured_Alcohol]]	[[Allyl_Isothiocyanate]],
[[Denmark]]	[[Fusidic_Acid]],[[Animal_Drug_Availability_Act_1996]],
[[Density]]	[[Dalfopristin]],
[[Dental_Antibiotic_Prophylaxis]]	[[Antibiotics]],[[Antibiotic_Misuse]],
[[Dental_Caries]]	[[Triclosan]],
[[Dental_Plaque]]	[[Triclosan]],
[[Deodorant]]	[[Triclosan]],[[Triclosan]],
[[Deoxyribose]]	[[Kedarcidin]],[[Kedarcidin]],
[[Department_Of_Health_And_Human_Services]]	[[Antibiotic_Resistance]],
[[Depolarization]]	[[Telavancin]],[[Daptomycin]],
[[Depression_(mood)]]	[[Cycloserine]],[[Clofazimine]],
[[Depsipeptide]]	[[Katanosin]],[[Pristinamycin]],[[Beauvericin]],
[[Depsipeptides]]	[[Streptogramin_B]],
[[Derivative_(chemistry)]]	[[Pulvinone]],[[Aspergillic_Acid]],
[[Dermal_Fibroblasts]]	[[MC21-B]],
[[Dermatitis_Herpetiformis]]	[[Dapsone]],[[Dapsone]],
[[Detoxification]]	[[Cruciferous_Vegetables]],
[[Detroit,_Michigan]]	[[Daptomycin]],
[[Dexamethasone]]	[[Tobramycin/dexamethasone]],
[[Diabetes]]	[[Isoniazid]],
[[Diabetes_Mellitus]]	[[Dapsone]],
[[Dial_(soap)]]	[[Triclosan]],
[[Diallyl_Disulfide]]	[[Allicin]],[[Allicin]],
[[Dialysis]]	[[Cathelicidin]],
[[Diarrhea]]	[[Surotomycin]],[[Nifuroxazide]],[[List_Of_Antibiotics]],[[Antibiotic_Resistance]],[[Antibiotics]],
[[Diarrhoea]]	[[Furazolidone]],
[[Diastereomer]]	[[TAN-1057_C]],[[TAN-1057_A]],
[[Diatom]]	[[Triclosan]],
[[Dicloxacillin]]	[[List_Of_Antibiotics]],
[[Dideoxyverticillin_A]]	[[Medicinal_Molds]],
[[Diene]]	[[Streptazolin]],
[[Dietary_Fiber]]	[[Cruciferous_Vegetables]],[[Medicinal_Mushroom]],
[[Diethyl_Ether]]	[[Monensin]],[[Triclosan]],
[[Diffusion]]	[[Production_Of_Antibiotics]],
[[Dihydroergocornine]]	[[Medicinal_Molds]],
[[Dihydroergocristine]]	[[Medicinal_Molds]],
[[Dihydroergotamine]]	[[Medicinal_Molds]],[[Medicinal_Mushroom]],
[[Dihydrofolate_Reductase_Inhibitor]]	[[Trimethoprim]],
[[Dihydrofolic_Acid]]	[[Dapsone]],
[[Dihydroisocoumarin]]	[[Phytoalexin]],
[[Dihydropteroate_Synthetase]]	[[List_Of_Antibiotics]],
[[Dihydropteroate_Synthetase_Inhibitor]]	[[Template:Antimycobacterials]],
[[Dihydropteroic_Acid]]	[[List_Of_Antibiotics]],
[[Diketopiperazine]]	[[Aspergillic_Acid]],
[[Dimethyl_Sulfoxide]]	[[Kendomycin]],
[[Dimethylallyl_Pyrophosphate]]	[[Novobiocin]],[[Novobiocin]],[[Platensimycin]],
[[Diosgenin]]	[[Medicinal_Molds]],
[[Dipeptide_Bond]]	[[Cycloserine]],
[[Diphtheria]]	[[Pyocyanase]],
[[Diplotaxis_Tenuifolia]]	[[Cruciferous_Vegetables]],
[[Dipole]]	[[Platensimycin]],
[[Dirithromycin]]	[[List_Of_Antibiotics]],
[[Discovery_And_Development_Of_Statins]]	[[Medicinal_Mushroom]],
[[Disinfectant]]	[[Bacteriostatic_Agent]],
[[Distaclor]]	[[List_Of_Antibiotics]],
[[Distal_Tubule]]	[[Trimethoprim]],
[[Distillation]]	[[Allyl_Isothiocyanate]],
[[Disulfide_Bond]]	[[Arenicin]],
[[Disulfiram]]	[[Antibiotics]],[[Isoniazid]],[[Trimethoprim]],
[[Diterpene]]	[[Aphidicolin]],[[Guanacastepene_A]],
[[Divalent]]	[[Surfactin]],
[[Docetaxel]]	[[Medicinal_Molds]],
[[Dolichol_Phosphate]]	[[Tunicamycin]],
[[Domestic_Pig]]	[[Animal_Drug_Availability_Act_1996]],[[Bambermycin]],
[[Doribax]]	[[List_Of_Antibiotics]],
[[Doripenem]]	[[List_Of_Antibiotics]],
[[Dormancy]]	[[Multidrug_Tolerance]],[[Multidrug_Tolerance]],
[[Dorothy_Crowfoot_Hodgkin]]	[[Antibiotics]],[[Thiostrepton]],
[[Dorothy_Hodgkin]]	[[Gramicidin_S]],
[[Dosing]]	[[Animal_Drug_Availability_Act_1996]],
[[Double_Bond]]	[[Platensimycin]],[[Enediyne]],[[Arsphenamine]],
[[Doxorubicin]]	[[Topoisomerase_Inhibitor]],[[Streptomyces_Isolates]],[[Topoisomerase_Inhibitor]],
[[Doxycycline]]	[[List_Of_Antibiotics]],
[[Drinking_Water]]	[[Triclosan]],
[[Drug]]	[[Antibiotics]],[[Nifurquinazol]],[[Animal_Drug_Availability_Act_1996]],[[Ethambutol]],
[[Drug_Development]]	[[Tanespimycin]],[[NXL103]],
[[Drug_Discovery]]	[[Medicinal_Molds]],
[[Drug_Efflux]]	[[Antibiotics]],
[[Drug_Interaction]]	[[Isoniazid]],
[[Drug_Of_Last_Resort]]	[[Antibiotic_Resistance]],
[[Drug_Resistance]]	[[Mupirocin]],[[Fusidic_Acid]],[[Antibiotic_Resistance]],[[Myxopyronin]],
[[Dry_Distillation]]	[[Aspergillic_Acid]],
[[Duclauxin]]	[[Medicinal_Molds]],
[[Duff_Reaction]]	[[Hexamethylenetetramine]],
[[Duricef]]	[[List_Of_Antibiotics]],
[[Dye]]	[[Dapsone]],
[[Dynabac]]	[[List_Of_Antibiotics]],
[[Dynemicin_A]]	[[Kedarcidin]],[[Enediyne]],
[[Dysarthria]]	[[Cycloserine]],
[[Dysbacteriosis]]	[[Antibiotic_Resistance]],
[[Dysgeusia]]	[[List_Of_Antibiotics]],
[[Dyspepsia]]	[[Nitrofurantoin]],
[[Dyspnea]]	[[Daptomycin]],[[Nitrofurantoin]],
[[E605]]	[[Arsphenamine]],
[[EC50]]	[[Salinosporamide_A]],
[[EDTA]]	[[4-Aminosalicylic_Acid]],
[[EHEC]]	[[Trimethoprim]],
[[E_Number]]	[[Hexamethylenetetramine]],
[[Ear_Canal]]	[[Acetic_Acid/hydrocortisone]],
[[Echinocandin]]	[[Medicinal_Mushroom]],
[[Echinocandins]]	[[Medicinal_Molds]],[[Lipopeptide]],
[[Ectomycorrhiza]]	[[Medicinal_Molds]],[[Medicinal_Mushroom]],
[[Eczema]]	[[Daptomycin]],[[Antibiotic_Misuse]],
[[Edema]]	[[Daptomycin]],
[[Efficacy]]	[[Reuterin]],
[[Efflux_(microbiology)]]	[[Antibiotic_Resistance]],[[Antibiotic_Resistance]],[[Antibiotic_Resistance]],[[Antibiotic_Resistance]],[[Antibiotics]],
[[Efrapeptin]]	[[Medicinal_Molds]],
[[Eimeria]]	[[Furazolidone]],
[[Electrochemical_Gradient]]	[[Antimycin_A]],
[[Electrochemical_Potential]]	[[Efflux_(microbiology)]],
[[Electrocyclic_Reaction]]	[[Endiandric_Acid_C]],
[[Electrolyte]]	[[Daptomycin]],
[[Electron_Transport_Chain]]	[[Pyocyanin]],[[Antimycin_A]],
[[Eli_Lilly_And_Company]]	[[Hexamethylenetetramine]],[[Daptomycin]],
[[Ellipticines]]	[[Topoisomerase_Inhibitor]],
[[Elongation_Factor]]	[[Fusidic_Acid]],
[[Elsamitrucin]]	[[Chartreusin]],
[[Elsevier]]	[[Pulvinone]],[[Pulvinone]],
[[Emil_Fromm]]	[[Promin]],
[[Empiric_Therapy]]	[[Broad-spectrum_Antibiotic]],
[[Endiandra_Introrsa]]	[[Endiandric_Acid_C]],
[[Endocarditis]]	[[Daptomycin]],[[Daptomycin]],[[Fusidic_Acid]],
[[Endocrine_Disruptor]]	[[Triclosan]],
[[Endogenous]]	[[Cycloserine]],
[[Endophytes]]	[[Streptomyces_Isolates]],
[[Endospore]]	[[Surfactin]],
[[Endospores]]	[[Antibiotic_Resistance]],
[[Endothelin_Receptor]]	[[Kendomycin]],
[[Enediyne]]	[[Kedarcidin]],[[Neocarzinostatin]],[[Kedarcidin]],[[Calicheamicin]],[[Esperamicin]],
[[Enniatin]]	[[Beauvericin]],
[[Enol]]	[[Endiandric_Acid_C]],[[Pulvinone]],
[[Enolpyruvyl_Transferase]]	[[List_Of_Antibiotics]],
[[Enone]]	[[Platensimycin]],
[[Enoxacin]]	[[List_Of_Antibiotics]],
[[Enteritis]]	[[Furazolidone]],[[List_Of_Antibiotics]],
[[Enterobacter]]	[[Nitrofurantoin]],[[Trimethoprim]],
[[Enterobacteriaceae]]	[[Antibiotics]],[[Antibiotics]],
[[Enterobactin]]	[[Nonribosomal_Peptide]],
[[Enterococcal]]	[[Dalfopristin]],
[[Enterococci]]	[[Katanosin]],
[[Enterococcus]]	[[Daptomycin]],[[Antibiotic_Resistance]],[[Trimethoprim]],[[Dalfopristin]],[[Antibiotic_Resistance]],
[[Enterococcus_Faecalis]]	[[Bottromycin]],[[Nitrofurantoin]],[[Antibiotic_Resistance]],
[[Enterococcus_Faecium]]	[[Dalfopristin]],[[Antibiotic_Resistance]],
[[Entomopathogenic_Fungi]]	[[Medicinal_Mushroom]],
[[Environmental_Protection_Agency]]	[[Triclosan]],
[[Enzyme]]	[[Production_Of_Antibiotics]],[[Cycloserine]],[[Trichostatin_A]],[[Vinyldithiin]],[[Allyl_Isothiocyanate]],[[Nonribosomal_Peptide]],[[Efflux_(microbiology)]],[[Fosfomycin]],[[Zwittermicin_A]],[[Zwittermicin_A]],
[[Enzyme_Catalysis]]	[[Topoisomerase_Inhibitor]],
[[Enzyme_Induction_And_Inhibition]]	[[Cruciferous_Vegetables]],
[[Enzyme_Inhibition]]	[[Tanespimycin]],[[Staurosporine]],
[[Enzyme_Inhibitor]]	[[Trichostatin_A]],[[Production_Of_Antibiotics]],[[List_Of_Antibiotics]],[[Cycloheximide]],[[Aphidicolin]],
[[Enzymes]]	[[Endiandric_Acid_C]],[[Mupirocin]],[[Topoisomerase_Inhibitor]],[[Enzybiotics]],[[Platensimycin]],[[User:Harmonslide/sandbox]],
[[Eosinophil]]	[[Gliotoxin]],
[[Eosinophilia]]	[[Dapsone]],[[Daptomycin]],
[[Eosinophilic_Pneumonia]]	[[Daptomycin]],
[[EpiCor]]	[[Medicinal_Molds]],[[Medicinal_Mushroom]],
[[Epidemiology]]	[[Antibiotic_Resistance]],
[[Epigallocatechin_Gallate]]	[[Topoisomerase_Inhibitor]],
[[Epigastric]]	[[Nitrofurantoin]],
[[Epimerization]]	[[Nonribosomal_Peptide]],[[Tyrocidine]],
[[Epirubicin]]	[[Streptomyces_Isolates]],
[[Epithelial]]	[[Hydramacin-1]],
[[Epithelial_Sodium_Channel]]	[[Trimethoprim]],
[[Epithelium]]	[[Cathelicidin]],
[[Epothilone]]	[[Nonribosomal_Peptide]],[[Nonribosomal_Peptide]],
[[Epoxide]]	[[Mupirocin]],
[[Equivalent_(chemistry)]]	[[Pulvinone]],
[[Eravacycline]]	[[Antibiotics]],
[[Ergine]]	[[Medicinal_Molds]],
[[Ergocalciferol]]	[[Medicinal_Mushroom]],
[[Ergometrine]]	[[Medicinal_Molds]],
[[Ergot_Alkaloid]]	[[Medicinal_Molds]],
[[Ergot_Alkaloids]]	[[Medicinal_Mushroom]],
[[Ergothioneine]]	[[Medicinal_Mushroom]],[[Medicinal_Mushroom]],[[Medicinal_Mushroom]],[[Medicinal_Mushroom]],
[[Ericoid_Mycorrhiza]]	[[Medicinal_Molds]],[[Medicinal_Mushroom]],
[[Erinacine]]	[[Medicinal_Mushroom]],
[[Eritadenine]]	[[Medicinal_Mushroom]],[[Medicinal_Mushroom]],
[[Ernest_Fourneau]]	[[Dapsone]],
[[Ernst_Boris_Chain]]	[[Production_Of_Antibiotics]],[[Antibiotics]],
[[Ernst_Chain]]	[[Antibiotics]],
[[Ertapenem]]	[[List_Of_Antibiotics]],[[Broad-spectrum_Antibiotic]],
[[Eruca_Sativa]]	[[Cruciferous_Vegetables]],
[[Erwinia_Amylovora]]	[[Efflux_(microbiology)]],
[[Erwinia_Chrysanthemi]]	[[Streptomyces_Isolates]],
[[Erythema]]	[[Spectinomycin]],[[Clofazimine]],
[[Erythocin]]	[[List_Of_Antibiotics]],
[[Erythrocyte]]	[[Nitrofurantoin]],
[[Erythrocytes]]	[[Geldanamycin]],
[[Erythromycin]]	[[Antibiotics]],[[Antibiotic_Resistance]],[[List_Of_Antibiotics]],[[Pristinamycin]],[[Carbomycin]],[[SmeT]],[[Carbomycin]],[[Erythromycin/sulfafurazole]],[[Mercer_Protocol]],
[[Erythroped]]	[[List_Of_Antibiotics]],
[[Escherichia_Coli]]	[[Fosfomycin]],[[(6S)-6-Fluoroshikimic_Acid]],[[Antibiotic_Resistance]],[[Trimethoprim]],[[Hydramacin-1]],[[List_Of_Antibiotics]],[[Endiandric_Acid_C]],[[Mupirocin]],[[Raphanin]],[[Nifuroxazide]],[[Triclosan]],[[Antibiotic_Resistance]],[[Thymineless_Death]],[[Streptomyces_Isolates]],[[Raphanin]],[[Furazolidone]],
[[Escherichia_Coli_O157:H7]]	[[Reuterin]],[[Reuterin]],
[[Esperamicin]]	[[Kedarcidin]],[[Enediyne]],[[Calicheamicin]],
[[Essential_Oil]]	[[Melafix]],
[[Ester]]	[[Endiandric_Acid_C]],[[Nonribosomal_Peptide]],[[Monensin]],[[Puromycin]],[[Pulvinone]],
[[Esterase]]	[[Nonribosomal_Peptide]],
[[Esterification]]	[[Mupirocin]],
[[Esther_Lederberg]]	[[Antibiotic_Resistance]],
[[Ethambutol]]	[[Template:Antimycobacterials]],[[4-Aminosalicylic_Acid]],[[Thioacetazone]],[[List_Of_Antibiotics]],[[Bacteriostatic_Agent]],
[[Ethanol]]	[[Triclosan]],[[Monensin]],
[[Ether]]	[[Triclosan]],
[[Ethionamide]]	[[Thiocarlide]],[[List_Of_Antibiotics]],[[Template:Antimycobacterials]],
[[Ethiopian_Mustard]]	[[Cruciferous_Vegetables]],
[[Ethylene]]	[[Phytoalexin]],
[[Ethylenediamine]]	[[Template:Antimycobacterials]],[[Ethambutol]],
[[Etoposide]]	[[Medicinal_Molds]],[[Topoisomerase_Inhibitor]],[[Topoisomerase_Inhibitor]],[[Salinomycin]],
[[Eucalyptus_Sideroxylon]]	[[Phytoalexin]],
[[Eukaryote]]	[[Cycloheximide]],[[Streptomyces_Isolates]],[[Aphidicolin]],[[Trichostatin_A]],[[Kanamycin]],[[Nonribosomal_Peptide]],
[[Eukaryotes]]	[[Puromycin]],
[[Eukaryotic]]	[[Zwittermicin_A]],[[Blasticidin_S]],
[[Eupenifeldin]]	[[Medicinal_Molds]],
[[European_Commission]]	[[Alliance_For_The_Prudent_Use_Of_Antibiotics]],
[[European_Medicines_Agency]]	[[4-Aminosalicylic_Acid]],
[[European_Union]]	[[Triclosan]],[[Subtherapeutic_Antibiotic_Use_In_Swine]],
[[Evolution]]	[[Antibiotics]],[[Antibiotic_Resistance]],
[[Experimental_Drug]]	[[Platensimycin]],
[[Exportin]]	[[Leptomycin]],
[[Extinction_(psychology)]]	[[Cycloserine]],[[Cycloserine]],
[[Extinction_Learning]]	[[Cycloserine]],
[[Extremophiles]]	[[Streptomyces_Isolates]],
[[Eye_Drop]]	[[Trimethoprim/polymyxin]],[[Trimethoprim/polymyxin]],[[Antibiotics]],[[Fusidic_Acid]],
[[Eye_Drops]]	[[Tobramycin/dexamethasone]],[[Tobramycin/dexamethasone]],
[[FAD]]	[[Kedarcidin]],
[[FDA]]	[[Ambazone]],
[[FIASMA]]	[[Clofazimine]],
[[FOXM1]]	[[Thiostrepton]],[[Thiostrepton]],
[[Factive]]	[[List_Of_Antibiotics]],
[[Farnesyl_Transferase]]	[[Gliotoxin]],
[[Farnesyl_Transferase_Inhibitor]]	[[Medicinal_Molds]],
[[Farnesyltransferase]]	[[Medicinal_Mushroom]],
[[Fast_Food]]	[[Animal_Drug_Availability_Act_1996]],
[[Fatty_Acid]]	[[Nonribosomal_Peptide]],[[Surfactin]],[[Mupirocin]],[[Platensimycin]],
[[Fatty_Acid_Synthase]]	[[Isoniazid]],
[[Fatty_Acid_Synthesis]]	[[Mupirocin]],
[[Fear_Conditioning]]	[[Cycloserine]],
[[Federal_Food,_Drug,_And_Cosmetic_Act]]	[[Animal_Drug_Availability_Act_1996]],
[[Female_Genital_Infection]]	[[Endiandric_Acid_C]],
[[Fermentation_(biochemistry)]]	[[A23187]],
[[Fermentek]]	[[Staurosporine]],[[Gliotoxin]],[[Trichostatin_A]],[[Aphidicolin]],[[Medicinal_Molds]],[[Thiostrepton]],[[Gliotoxin]],[[Geldanamycin]],[[A23187]],[[Thiolutin]],[[Bafilomycin]],[[Myriocin]],[[Leptomycin]],[[Puromycin]],
[[Ferredoxin]]	[[Antimycin_A]],
[[Ferrier_Rearrangement]]	[[Streptazolin]],
[[Fetus]]	[[4-Aminosalicylic_Acid]],
[[Fever]]	[[Dapsone]],
[[Fi:Cruciferous_Vihannekset]]	[[Cruciferous_Vegetables]],
[[Fibrotic]]	[[Avenanthramide]],
[[Fidaxomicin]]	[[Antibiotics]],
[[Field_Study]]	[[Animal_Drug_Availability_Act_1996]],
[[Field_Trial]]	[[Animal_Drug_Availability_Act_1996]],
[[Filtrate]]	[[Aspergillic_Acid]],
[[Fin_Rot]]	[[Melafix]],
[[Fingolimod]]	[[Myriocin]],[[Medicinal_Molds]],
[[Finnish_Language]]	[[Alliance_For_The_Prudent_Use_Of_Antibiotics]],
[[Fish]]	[[Antimycin_A]],
[[Fisheries]]	[[Antimycin_A]],
[[Flagyl]]	[[List_Of_Antibiotics]],
[[Flammulina_Velutipes]]	[[Medicinal_Mushroom]],
[[Flavacol]]	[[Aspergillic_Acid]],
[[Flavanone]]	[[Phytoalexin]],
[[Flavoprotein]]	[[Nitrofurantoin]],
[[Flavoring]]	[[Allyl_Isothiocyanate]],
[[Flexibacter]]	[[TAN-1057_C]],[[TAN-1057_A]],
[[Flomoxef]]	[[Oxacephem]],[[Oxacephem]],
[[Flopristin]]	[[NXL103]],
[[Flora]]	[[Broad-spectrum_Antibiotic]],
[[Flowering_Cabbage]]	[[Cruciferous_Vegetables]],
[[Floxapen]]	[[List_Of_Antibiotics]],
[[Floxin]]	[[List_Of_Antibiotics]],
[[Flucloxacillin]]	[[List_Of_Antibiotics]],[[Daptomycin]],
[[Flucytosine]]	[[Nucleic_Acid_Inhibitor]],
[[Fluid]]	[[Surfactin]],
[[Fluorescence_In_The_Life_Sciences]]	[[Staurosporine]],
[[Fluorocycline]]	[[Eravacycline]],
[[Fluoroquinolone]]	[[Antibiotic_Resistance]],[[Animal_Drug_Availability_Act_1996]],[[Antibiotic_Resistance]],[[Novobiocin]],[[Antibiotic_Misuse]],[[Antibiotic_Resistance]],
[[Fluoroquinolones]]	[[Topoisomerase_Inhibitor]],[[Nitrofurantoin]],
[[Fluorouracil]]	[[Thymineless_Death]],
[[Folate]]	[[List_Of_Antibiotics]],
[[Folate_Synthesis]]	[[List_Of_Antibiotics]],
[[Folic_Acid]]	[[Trimethoprim]],[[Antibiotic_Resistance]],
[[Folk_Medicine]]	[[Antibiotics]],
[[Fomes_Fomentarius]]	[[Medicinal_Mushroom]],
[[Food_Additive]]	[[Hexamethylenetetramine]],
[[Food_And_Chemical_Toxicology]]	[[Medicinal_Mushroom]],
[[Food_And_Drug_Administration]]	[[Telavancin]],[[4-Aminosalicylic_Acid]],[[Triclosan]],[[Subtherapeutic_Antibiotic_Use_In_Swine]],[[Nitrofurantoin]],[[Fosfomycin/tobramycin]],[[Antibiotics]],[[Triclosan]],[[Antibiotics]],[[Triclosan]],[[Antibiotic_Resistance]],[[Avenanthramide]],[[Daptomycin]],[[Lipoglycopeptide]],
[[Food_Preservation]]	[[Antibiotic_Resistance]],
[[Food_Preservative]]	[[Reuterin]],
[[Foodborne_Illness]]	[[Subtherapeutic_Antibiotic_Use_In_Swine]],
[[Force_Field_(chemistry)]]	[[Kedarcidin]],
[[Formaldehyde]]	[[Hexamethylenetetramine]],[[Hexamethylenetetramine]],
[[Formalin]]	[[Ristocetin]],
[[Formylation]]	[[Nonribosomal_Peptide]],
[[Fortaz]]	[[List_Of_Antibiotics]],
[[Fosfomycin]]	[[Fosfomycin/tobramycin]],[[Fosfomycin/tobramycin]],[[List_Of_Antibiotics]],[[Streptomyces_Isolates]],
[[France]]	[[Clofoctol]],
[[Francisella]]	[[Fosmidomycin]],
[[Frankfurt]]	[[Neosalvarsan]],
[[Franklin_Expedition]]	[[Antibiotic_Resistance]],
[[Free_Radical_Biology_And_Medicine]]	[[Pyocyanin]],
[[Free_Radicals]]	[[List_Of_Antibiotics]],
[[Fucibet]]	[[Fusidic_Acid]],
[[Fucidin]]	[[List_Of_Antibiotics]],
[[Full_Blood_Count]]	[[Dapsone]],
[[Fumagillin]]	[[Medicinal_Mushroom]],[[Medicinal_Molds]],
[[Functional_Group]]	[[Platensimycin]],[[Triclosan]],[[Platensimycin]],
[[Fungal_Infection_In_Plants]]	[[Phytoalexin]],[[Phytoalexin]],
[[Fungal_Isolates]]	[[Medicinal_Molds]],[[Streptomyces_Isolates]],
[[Fungi]]	[[Hitachimycin]],[[Pulvinone]],[[Streptomyces_Isolates]],[[Hexamethylenetetramine]],[[Nonribosomal_Peptide]],
[[Fungicide]]	[[Validamycin]],[[Aspergillic_Acid]],[[Cycloheximide]],[[Allistatin]],[[Surfactin]],
[[Fungus]]	[[Guanacastepene_A]],[[Beauvericin]],[[Pulvinone]],[[Triclosan]],[[A23187]],[[Gliotoxin]],
[[Furanomycin]]	[[Mupirocin]],
[[Furazolidone]]	[[List_Of_Antibiotics]],[[Nitrofurantoin]],[[Antibiotics]],
[[Furuncle]]	[[Mupirocin]],
[[Fusafungine]]	[[Medicinal_Mushroom]],[[Medicinal_Molds]],
[[Fusarium]]	[[Beauvericin]],
[[Fusidate]]	[[Taksta]],
[[Fusidic_Acid]]	[[Medicinal_Mushroom]],[[Pristinamycin]],[[List_Of_Antibiotics]],[[Medicinal_Molds]],[[Taksta]],
[[Fusidium]]	[[Fusidic_Acid]],
[[G1_Phase]]	[[Tunicamycin]],
[[G6PD_Deficiency]]	[[Dapsone]],
[[GABA]]	[[Cycloserine]],
[[GABA_Transaminase]]	[[Cycloserine]],
[[GPCR]]	[[Lipopeptide]],
[[Ganoderic_Acid]]	[[Medicinal_Mushroom]],
[[Ganoderma_Lucidum]]	[[Medicinal_Mushroom]],
[[Garamycin]]	[[List_Of_Antibiotics]],
[[Garden_Cress]]	[[Cruciferous_Vegetables]],
[[Garlic]]	[[Phytoalexin]],[[Vinyldithiin]],[[Allicin]],[[Allyl_Isothiocyanate]],[[Phytoalexin]],[[Allistatin]],
[[Garlicin]]	[[Allistatin]],
[[Gastric_Juices]]	[[Antibiotics]],
[[Gastrointestinal_Tract]]	[[Ramoplanin]],[[Ethambutol]],
[[Gatifloxacin]]	[[List_Of_Antibiotics]],[[Broad-spectrum_Antibiotic]],[[Ethionamide]],
[[Gb:cruciferous_Llysiau]]	[[Cruciferous_Vegetables]],
[[Geigy]]	[[Clofazimine]],
[[Geldanamycin]]	[[List_Of_Antibiotics]],[[Nigericin]],[[Tanespimycin]],[[Ansamycin]],[[Herbimycin]],[[Ansamycin]],[[17-Dimethylaminoethylamino-17-demethoxygeldanamycin]],
[[Gemifloxacin]]	[[List_Of_Antibiotics]],
[[Gemtuzumab_Ozogamicin]]	[[Calicheamicin]],
[[Genbank]]	[[Blasticidin_S]],
[[Gene]]	[[Zwittermicin_A]],[[Antibiotic_Resistance]],[[Trichostatin_A]],[[Production_Of_Antibiotics]],[[Hydramacin-1]],[[Efflux_(microbiology)]],[[Zwittermicin_A]],
[[Gene_Cassette]]	[[Kanamycin]],
[[Gene_Cluster]]	[[User:Harmonslide/sandbox]],[[Mupirocin]],[[Nonribosomal_Peptide]],[[Actinorhodin]],[[Fosfomycin]],[[Nonribosomal_Peptide]],
[[Gene_Expression]]	[[Trichostatin_A]],[[Efflux_(microbiology)]],[[Efflux_(microbiology)]],
[[Gene_Knockout]]	[[Mupirocin]],
[[Gene_Regulation]]	[[Platensimycin]],
[[Generic_Drug]]	[[Trimethoprim]],
[[Genes]]	[[Antibiotic_Resistance]],[[User:Harmonslide/sandbox]],[[Resistome]],
[[Genetic_Engineering]]	[[Blasticidin_S]],[[Antibiotic_Resistance]],
[[Genetically_Modified_Organism]]	[[Production_Of_Antibiotics]],
[[Geneticin]]	[[Kanamycin]],
[[Geneticist]]	[[Gramicidin_S]],
[[Genistein]]	[[Topoisomerase_Inhibitor]],[[Topoisomerase_Inhibitor]],
[[Genome]]	[[Antibiotic_Resistance]],[[Antibiotics]],[[Spectinomycin]],
[[Gentamicin]]	[[Enzybiotics]],[[Fusidic_Acid]],[[List_Of_Antibiotics]],
[[Genus]]	[[Cruciferous_Vegetables]],
[[Georgyi_Frantsevitch_Gause]]	[[Gramicidin_S]],
[[Geranylgeranyl_Pyrophosphate]]	[[Platensimycin]],
[[Gerhard_Domagk]]	[[Dapsone]],[[Antibiotics]],
[[Gerhard_Schmidt_(biologist)]]	[[Gramicidin_S]],
[[Germany]]	[[Pyocyanase]],[[Neosalvarsan]],
[[Giardia_Lamblia]]	[[Furazolidone]],[[Furazolidone]],
[[Giardiasis]]	[[Furazolidone]],[[List_Of_Antibiotics]],
[[Gilead_Sciences]]	[[Fosfomycin/tobramycin]],
[[Gingivitis]]	[[Triclosan]],
[[Ginkgolide]]	[[Medicinal_Molds]],
[[Giuseppe_Castiglione_(Jesuit)]]	[[Medicinal_Mushroom]],
[[Glacial_Acetic_Acid]]	[[Dapsone]],
[[Glaser_Coupling]]	[[Kedarcidin]],
[[Glaucoma]]	[[Tobramycin/dexamethasone]],
[[GlaxoSmithKline]]	[[Furazolidone]],[[Nifuroxazide]],[[Trimethoprim]],[[Antibiotic_Resistance]],
[[GlaxoSmithKline_Plc]]	[[Nifuroxazide]],
[[Glioblastoma]]	[[Staurosporine]],
[[Gliotoxin]]	[[Medicinal_Molds]],
[[Globozoospermia]]	[[A23187]],
[[Glomerular_Basement_Membrane]]	[[Hexamethylenetetramine]],
[[Glucan]]	[[Thiolutin]],
[[Glucocorticoid]]	[[Tobramycin/dexamethasone]],
[[Glucose]]	[[Staurosporine]],[[Actaplanin]],
[[Glucosinolate]]	[[Allyl_Isothiocyanate]],
[[Glucuronidation]]	[[Clofoctol]],
[[Glutamate]]	[[Cycloserine]],[[Cycloserine]],[[Cycloserine]],
[[Glutamatergic]]	[[Cycloserine]],
[[Glutamic_Acid]]	[[Surfactin]],
[[Glutathione]]	[[Fosfomycin]],[[Pyocyanin]],[[Raphanin]],[[Nitrofurantoin]],[[Nitrofurantoin]],
[[Glycerol]]	[[Reuterin]],[[Platensimycin]],
[[Glycine]]	[[Cycloserine]],[[Cycloserine]],
[[Glycolysis]]	[[Platensimycin]],
[[Glycomics]]	[[Phytoalexin]],
[[Glycopeptide]]	[[Lipoglycopeptide]],[[Daptomycin]],
[[Glycopeptide_Antibiotic]]	[[List_Of_Antibiotics]],
[[Glycopeptides]]	[[Antibiotic_Resistance]],
[[Glycoprotein]]	[[Tunicamycin]],[[Tunicamycin]],
[[Glycoprotein_Ib_(GPIb)]]	[[Ristocetin]],
[[Glycosylation]]	[[Nonribosomal_Peptide]],[[Nonribosomal_Peptide]],[[Tunicamycin]],
[[Glycylcyclines]]	[[Antibiotics]],
[[Glycyrrhiza_Uralensis]]	[[Glycyrrhizol]],
[[Goitre]]	[[4-Aminosalicylic_Acid]],
[[Goitrogen]]	[[Cruciferous_Vegetables]],
[[Golgi_Apparatus]]	[[Nigericin]],
[[Gonorrhea]]	[[Spectinomycin]],[[Spectinomycin]],[[List_Of_Antibiotics]],[[List_Of_Antibiotics]],
[[Grain]]	[[Beauvericin]],
[[Gram]]	[[Surfactin]],[[Hitachimycin]],[[Platensimycin]],[[Dapsone]],
[[Gram_Negative]]	[[Gramicidin_S]],
[[Gram_Negative_Bacteria]]	[[Streptogramin_B]],
[[Gram_Negative_Bacterium]]	[[Pyocyanin]],
[[Gram_Positive]]	[[Streptolydigin]],[[Nigericin]],[[Streptogramin_B]],[[Gramicidin_S]],[[A23187]],[[Gramicidin_S]],
[[Gram_Positive_Bacteria]]	[[NXL103]],[[Efflux_(microbiology)]],
[[Gramicidin]]	[[Tyrocidine]],[[Nonribosomal_Peptide]],[[Gramicidin_S]],[[Antibiotics]],[[Tyrocidine]],[[Gramicidin_S]],
[[Gramicidin_D]]	[[Gramicidin_S]],
[[Granulocyte]]	[[Cathelicidin]],
[[Granulocytes]]	[[Gliotoxin]],
[[Granuloma_Inguinale]]	[[Carbomycin]],
[[Great_Britain]]	[[Gramicidin_S]],
[[Great_Depression]]	[[Albert_Schatz_(scientist)]],
[[Greek_Language]]	[[Antibiotics]],
[[Grepafloxacin]]	[[List_Of_Antibiotics]],
[[Grifola_Frondosa]]	[[Medicinal_Mushroom]],[[Medicinal_Mushroom]],
[[Grippe]]	[[Allistatin]],
[[Griseofulvin]]	[[Medicinal_Molds]],[[Medicinal_Mushroom]],[[Medicinal_Molds]],
[[Groats]]	[[Avenanthramide]],
[[Growth_Medium]]	[[Production_Of_Antibiotics]],
[[Guadinomine]]	[[Streptomyces_Isolates]],
[[Guanidine]]	[[Trimethoprim]],
[[Guinea_Pig]]	[[Promin]],
[[Guinness_Yeast_Extract]]	[[Medicinal_Molds]],[[Medicinal_Mushroom]],
[[Gut_Flora]]	[[Reuterin]],
[[Guy_Henry_Faget]]	[[Promin]],
[[Gyrase]]	[[Topoisomerase_Inhibitor]],
[[HIV]]	[[Isoniazid]],[[Nigericin]],[[Surfactin]],[[Dapsone]],[[Ceragenin]],
[[HMPA]]	[[Endiandric_Acid_C]],
[[Habitat]]	[[Antibiotic_Resistance]],
[[Hadith]]	[[Medicinal_Mushroom]],[[Medicinal_Mushroom]],
[[Haemolysis]]	[[4-Aminosalicylic_Acid]],
[[Haemolytic_Anaemia]]	[[Nitrofurantoin]],
[[Haemophilus_Influenzae]]	[[Trimethoprim]],
[[Haloarchaea]]	[[Archaeocin]],
[[Halobacteriaceae]]	[[Archaeocin]],
[[Halogen]]	[[Salinosporamide_A]],
[[Halogenation]]	[[Nonribosomal_Peptide]],[[Nonribosomal_Peptide]],
[[Haloperidol]]	[[Cruciferous_Vegetables]],
[[Hand_Sanitizer]]	[[Triclosan]],
[[Harvard_University]]	[[Kedarcidin]],
[[HbA1c]]	[[Dapsone]],
[[HeLa]]	[[Aphidicolin]],
[[Headache]]	[[List_Of_Antibiotics]],[[Dapsone]],
[[Health_Canada]]	[[Triclosan]],
[[Health_Protection_Agency]]	[[Antibiotics]],
[[Health_System]]	[[Dapsone]],[[Mupirocin]],[[Nitrofurantoin]],[[Spectinomycin]],[[Clofazimine]],[[Ethambutol]],[[Trimethoprim]],
[[Healthy_Skepticism]]	[[Nifuroxazide]],[[Nifuroxazide]],[[Nifuroxazide]],
[[Heart_Disease]]	[[Avenanthramide]],
[[Heartwood]]	[[Phytoalexin]],
[[Heat]]	[[4-Aminosalicylic_Acid]],
[[Heat_Shock_Protein]]	[[Macbecin]],
[[Heavy_Metals]]	[[Antibiotic_Resistance]],[[Medicinal_Mushroom]],
[[Helicobacter_Pylori]]	[[Furazolidone]],[[Cruciferous_Vegetables]],
[[Hematological_Malignancy]]	[[Trimethoprim]],
[[Hemolysis]]	[[Hitachimycin]],[[Nitrofurantoin]],[[Gramicidin_S]],[[Dapsone]],
[[Hemolytic]]	[[Surfactin]],
[[Hemolytic_Anemia]]	[[Dapsone]],[[Nitrofurantoin]],
[[Hemophilus_Influenzae]]	[[Erythromycin/sulfafurazole]],
[[Hemorrhagic_Cystitis]]	[[Hexamethylenetetramine]],
[[Henry_Holt_And_Company]]	[[Antibiotic_Misuse]],
[[Hepatic]]	[[Clofoctol]],[[Trimethoprim]],
[[Hepatic_Impairment]]	[[Dalfopristin]],
[[Hepatitis]]	[[Isoniazid]],[[4-Aminosalicylic_Acid]],[[Nitrofurantoin]],[[Dapsone]],
[[Hepatotoxicity]]	[[Geldanamycin]],[[Ethambutol]],
[[Herbalism]]	[[Allistatin]],
[[Herbicide]]	[[Herbimycin]],
[[Herbimycin]]	[[List_Of_Antibiotics]],
[[Herbivore]]	[[Allyl_Isothiocyanate]],
[[Heredity]]	[[Multidrug_Tolerance]],
[[Hericenone]]	[[Medicinal_Mushroom]],
[[Hericium_Erinaceus]]	[[Medicinal_Mushroom]],
[[Herpes_Simplex_Virus]]	[[Surfactin]],
[[Herpetic_Infection]]	[[Tobramycin/dexamethasone]],
[[Heterocycle]]	[[User:Harmonslide/sandbox]],[[Hexamethylenetetramine]],
[[Heterocyclic]]	[[Polyoxins]],[[Roseophilin]],
[[Heterologous_Expression]]	[[Streptomyces_Isolates]],
[[Hexachlorophene]]	[[Triclosan]],
[[Hexamethylene_Triperoxide_Diamine]]	[[Hexamethylenetetramine]],[[Hexamethylenetetramine]],
[[Hexamine_Fuel_Tablet]]	[[Hexamethylenetetramine]],
[[Hexane]]	[[Guanacastepene_A]],
[[Hexion]]	[[Hexamethylenetetramine]],
[[High_Anion_Gap_Metabolic_Acidosis]]	[[Isoniazid]],
[[Hiroshige_II]]	[[Medicinal_Mushroom]],
[[Hispidin]]	[[Medicinal_Mushroom]],[[Medicinal_Mushroom]],
[[Hispolon]]	[[Medicinal_Mushroom]],
[[Histamine]]	[[Avenanthramide]],
[[Histology]]	[[Hexamethylenetetramine]],
[[Histomonas_Meleagridis]]	[[Furazolidone]],
[[Histone_Deacetylase]]	[[Trichostatin_A]],
[[Histone_Deacetylase_Inhibitor]]	[[Trichostatin_A]],[[Trichostatin_A]],
[[Histone_Deacetylases]]	[[Trichostatin_A]],
[[Histones]]	[[Trichostatin_A]],
[[History]]	[[The_Demon_Under_The_Microscope]],
[[History_Of_Penicillin]]	[[Antibiotics]],
[[Hoechst_33258]]	[[Netropsin]],
[[Hoechst_AG]]	[[Arsphenamine]],
[[Hokkaido]]	[[Medicinal_Mushroom]],
[[Homology_(biology)]]	[[Tunicamycin]],
[[Horizontal_Gene_Transfer]]	[[Antibiotic_Resistance]],[[Antibiotics]],[[Antibiotic_Resistance]],[[Multidrug_Tolerance]],[[Kanamycin]],[[Antibiotic_Resistance]],[[Antibiotics]],
[[Horseradish]]	[[Allyl_Isothiocyanate]],[[Allicin]],[[Cruciferous_Vegetables]],
[[Horseradish_Peroxidase]]	[[Medicinal_Mushroom]],
[[Horseshoe_Crab]]	[[Tachyplesin]],
[[Howard_Florey,_Baron_Florey]]	[[Antibiotics]],
[[Howard_Florey]]	[[Antibiotics]],
[[Howard_Walter_Florey]]	[[Production_Of_Antibiotics]],
[[Hsp90]]	[[Macbecin]],[[Tanespimycin]],[[Geldanamycin]],[[Herbimycin]],
[[Huimin_Zhao]]	[[Fosfomycin]],
[[Human_Eye]]	[[Tobramycin/dexamethasone]],
[[Human_Pathogen]]	[[Gliotoxin]],
[[Human_Skin]]	[[Antibiotic_Resistance]],
[[Human_Umbilical_Vein_Endothelial_Cell]]	[[Thiolutin]],
[[Humatin]]	[[List_Of_Antibiotics]],
[[Huperzine_A]]	[[Medicinal_Molds]],
[[Hydergine]]	[[Medicinal_Molds]],[[Medicinal_Mushroom]],
[[Hydnellum_Peckii]]	[[Medicinal_Mushroom]],
[[Hydra_(genus)]]	[[Hydramacin-1]],[[Hydramacin-1]],
[[Hydrazide]]	[[Template:Antimycobacterials]],
[[Hydrazine]]	[[Isoniazid]],
[[Hydrobromic_Acid]]	[[Aspergillic_Acid]],
[[Hydrochloride]]	[[Spectinomycin]],
[[Hydrocortisone]]	[[Acetic_Acid/hydrocortisone]],[[Fusidic_Acid]],
[[Hydrogen]]	[[Efflux_(microbiology)]],[[Carbomycin]],
[[Hydrogen_Bond]]	[[Surfactin]],[[Platensimycin]],
[[Hydrogen_Bonds]]	[[Arenicin]],
[[Hydrogen_Peroxide]]	[[Dalfopristin]],[[Phytoalexin]],[[Hexamethylenetetramine]],[[Antibiotics]],[[Pyocyanin]],
[[Hydrogen_Sulfide]]	[[Raphanin]],
[[Hydroid_(zoology)]]	[[Hydramacin-1]],
[[Hydrolysis]]	[[Aspergillic_Acid]],[[Puromycin]],[[Nonribosomal_Peptide]],[[Bottromycin]],
[[Hydrolyze]]	[[Endiandric_Acid_C]],
[[Hydroperoxide]]	[[Vinyldithiin]],
[[Hydrophilic]]	[[AGG01]],[[Surfactin]],
[[Hydrophobic]]	[[AGG01]],[[Dalfopristin]],[[Dalfopristin]],[[Hydramacin-1]],[[Surfactin]],
[[Hydrophobicity]]	[[Efflux_(microbiology)]],
[[Hydrophobins]]	[[Medicinal_Mushroom]],
[[Hydroquinone]]	[[Macbecin]],
[[Hydroxylamine]]	[[Cycloserine]],
[[Hydroxylated]]	[[Aspergillic_Acid]],
[[Hydroxylation]]	[[Nonribosomal_Peptide]],[[Nonribosomal_Peptide]],
[[Hydroxyproline]]	[[Peptaibol]],
[[Hydroxypyrazine]]	[[Aspergillic_Acid]],
[[Hygiene_Hypothesis]]	[[Triclosan]],[[Triclosan]],
[[Hygroscopic]]	[[Herbimycin]],
[[Hygroscopy]]	[[Arsphenamine]],
[[Hyperglycemia]]	[[Daptomycin]],
[[Hypericin]]	[[Medicinal_Molds]],
[[Hyperkalemia]]	[[Trimethoprim]],
[[Hypersensitive_Response]]	[[Phytoalexin]],[[Phytoalexin]],
[[Hypersensitivity]]	[[Tobramycin/dexamethasone]],[[Daptomycin]],[[Dapsone]],
[[Hypertension]]	[[Daptomycin]],
[[Hyphae]]	[[Medicinal_Mushroom]],
[[Hyphal]]	[[Streptomyces_Isolates]],
[[Hypholoma_Sublateritium]]	[[Medicinal_Mushroom]],
[[Hypholomine_B]]	[[Medicinal_Mushroom]],[[Medicinal_Mushroom]],
[[Hypokalaemia]]	[[Daptomycin]],
[[Hypomagnesemia]]	[[Daptomycin]],
[[Hypoplastic_Left_Heart_Syndrome]]	[[Nitrofurantoin]],
[[Hypotension]]	[[Daptomycin]],
[[Hypotheses]]	[[Surfactin]],
[[Hypsizygus_Tessellatus]]	[[Medicinal_Mushroom]],
[[IC50]]	[[Trichostatin_A]],
[[IG_Farben]]	[[The_Demon_Under_The_Microscope]],[[Antibiotics]],
[[IVF]]	[[A23187]],
[[Icthyosis]]	[[Clofazimine]],
[[Id:Sayuran]]	[[Cruciferous_Vegetables]],
[[Idarubicin]]	[[Streptomyces_Isolates]],
[[Idiopathic_Thrombocytopenic_Purpura]]	[[Dapsone]],
[[Illudin]]	[[Medicinal_Mushroom]],
[[Imidazole]]	[[Platensimycin]],[[Solithromycin]],
[[Imine]]	[[Staurosporine]],
[[Imipenem]]	[[List_Of_Antibiotics]],[[Antibiotics]],[[Broad-spectrum_Antibiotic]],
[[Immune]]	[[Antibiotics]],
[[Immune_Response]]	[[Antimicrobial_Pharmacodynamics]],
[[Immune_System]]	[[Antibiotics]],[[Ascofuranone]],[[Gliotoxin]],[[Medicinal_Molds]],
[[Immunofluorescence]]	[[Puromycin]],
[[Immunologic_Adjuvant]]	[[Medicinal_Mushroom]],
[[Immunomodulation]]	[[Antibiotics]],
[[Immunosuppressant]]	[[Nonribosomal_Peptide]],[[Nonribosomal_Peptide]],[[Myriocin]],
[[Immunosuppressive]]	[[Gliotoxin]],[[Tobramycin/dexamethasone]],[[Bafilomycin]],
[[Immunosuppressive_Drug]]	[[Streptomyces_Isolates]],
[[Imperial_Chemical_Industries]]	[[Pulvinone]],
[[Impetigo]]	[[Mupirocin]],[[List_Of_Antibiotics]],
[[Implant_(medicine)]]	[[Multidrug_Tolerance]],
[[In_Vitro]]	[[Platensimycin]],[[Solithromycin]],[[Fosmidomycin]],[[Fusidic_Acid]],[[Trimethoprim]],[[Allyl_Isothiocyanate]],[[Avenanthramide]],[[Salinosporamide_A]],[[Gramicidin_S]],[[Arenicin]],[[Dalfopristin]],
[[In_Vivo]]	[[Arenicin]],[[Carbomycin]],[[Gliotoxin]],
[[Inclusion_Bodies]]	[[Streptomyces_Isolates]],
[[Index_Of_Environmental_Articles]]	[[Antibiotic_Resistance]],
[[India]]	[[Surfactin]],
[[Indigoidine]]	[[Nonribosomal_Peptide]],
[[Indolocarbazole]]	[[Staurosporine]],
[[Industrial_Fermentation]]	[[Thiolutin]],[[Production_Of_Antibiotics]],[[Antibiotics]],[[Chromomycin_A3]],[[Bafilomycin]],
[[Inex_Pharmaceuticals_Corporation]]	[[A23187]],
[[Infection]]	[[Antibiotics]],[[Multidrug_Tolerance]],[[Kanamycin]],[[Multidrug_Tolerance]],[[Solithromycin]],[[Dalfopristin]],
[[Infection_And_Immunity]]	[[Pyocyanin]],[[Pyocyanin]],[[Pyocyanin]],[[Pyocyanin]],
[[Infection_Control]]	[[Antibiotic_Resistance]],
[[Infectious_Disease]]	[[Multidrug_Tolerance]],[[Alliance_For_The_Prudent_Use_Of_Antibiotics]],[[Alliance_For_The_Prudent_Use_Of_Antibiotics]],
[[Infectious_Disease_Society_Of_America]]	[[Antibiotics]],
[[Infectious_Diseases_Society_Of_America]]	[[Alliance_For_The_Prudent_Use_Of_Antibiotics]],
[[Infective_Endocarditis]]	[[Antibiotic_Misuse]],
[[Inflammation]]	[[Allicin]],[[Antibiotics]],
[[Inflammatory_Bowel_Disease]]	[[4-Aminosalicylic_Acid]],
[[Influenza_Vaccine]]	[[Antibiotic_Resistance]],
[[Injection_(medicine)]]	[[Spectinomycin]],
[[Innate_Immune_System]]	[[Cathelicidin]],
[[Innate_Immunity]]	[[Brilacidin]],
[[Inner_Mitochondrial_Membrane]]	[[Antimycin_A]],
[[Inonotus_Obliquus]]	[[Medicinal_Mushroom]],[[Medicinal_Mushroom]],
[[Inotilone]]	[[Medicinal_Mushroom]],[[Medicinal_Mushroom]],[[Medicinal_Mushroom]],
[[Inotodiol]]	[[Medicinal_Mushroom]],
[[Inotuzumab_Ozogamicin]]	[[Calicheamicin]],[[Kedarcidin]],
[[Insect]]	[[Antibiosis]],
[[Insecticide]]	[[Allyl_Isothiocyanate]],[[Beauvericin]],
[[Insomnia]]	[[Dapsone]],[[Antibiotic_Misuse]],
[[Insulin_Analog]]	[[Medicinal_Molds]],
[[Intercalation_(chemistry)]]	[[Kedarcidin]],[[Streptomyces_Isolates]],
[[Interfungin]]	[[Medicinal_Mushroom]],
[[Interleukin_3]]	[[A23187]],
[[International_Centre_For_Diarrhoeal_Disease_Research,_Bangladesh]]	[[Alliance_For_The_Prudent_Use_Of_Antibiotics]],
[[International_Journal_Of_Medical_Microbiology]]	[[Albomycin]],
[[International_Journal_Of_Nanomedicine]]	[[Staurosporine]],
[[International_Nonproprietary_Name]]	[[Pristinamycin]],[[Tobramycin/dexamethasone]],[[Ramoplanin]],[[Ethionamide]],[[Nitrofural]],[[Nifuroxazide]],[[Enviomycin]],[[Thioacetazone]],[[Trimethoprim]],[[Trimethoprim/polymyxin]],
[[International_Normalised_Ratio]]	[[Daptomycin]],
[[International_Red_Cross]]	[[Gramicidin_S]],
[[Interstitial_Pneumonitis]]	[[Nitrofurantoin]],
[[Intestinal_Flora]]	[[Antibiotics]],
[[Intracellular]]	[[Monensin]],
[[Intramolecular]]	[[Pulvinone]],
[[Intramuscular_Injection]]	[[Kanamycin]],
[[Intraocular_Pressure]]	[[Tobramycin/dexamethasone]],
[[Intravascular]]	[[Surfactin]],[[Nitrofurantoin]],
[[Intravenous]]	[[Kanamycin]],[[Daptomycin]],[[Antibiotics]],[[Pristinamycin]],
[[Intravenous_Therapy]]	[[Kanamycin]],[[Solithromycin]],
[[Invanz]]	[[List_Of_Antibiotics]],
[[Invertebrates]]	[[Plectasin]],
[[Iodine]]	[[Cruciferous_Vegetables]],[[Cruciferous_Vegetables]],
[[Ion]]	[[Gramicidin_S]],[[Beauvericin]],[[A23187]],
[[Ion_Channel]]	[[Surfactin]],
[[Ion_Exchange]]	[[Production_Of_Antibiotics]],
[[Ion_Gradient]]	[[Efflux_(microbiology)]],
[[Ionizable]]	[[Dalfopristin]],
[[Ionization]]	[[Efflux_(microbiology)]],
[[Ionophore]]	[[Monensin]],[[A23187]],[[Salinomycin]],[[Nigericin]],[[A23187]],[[A23187]],
[[Ionophores]]	[[Monensin]],
[[Ionopores]]	[[Antibiotic_Resistance]],
[[Ionotropic_Receptor]]	[[Cycloserine]],
[[Ions]]	[[Efflux_(microbiology)]],
[[Iproniazid]]	[[Isoniazid]],
[[Iraq]]	[[Antibiotic_Resistance]],
[[Iraq_War]]	[[Antibiotic_Resistance]],
[[Irinotecan]]	[[Topoisomerase_Inhibitor]],[[Medicinal_Molds]],
[[Iron_Trichloride]]	[[Aspergillic_Acid]],
[[Isaria]]	[[Fusidic_Acid]],
[[Isaria_Sinclairii]]	[[Myriocin]],
[[Ischemic_Stroke]]	[[Vinyldithiin]],
[[Isoflavonoid]]	[[Glycyrrhizol]],
[[Isoflavonoids]]	[[Phytoalexin]],
[[Isoform]]	[[Surfactin]],
[[Isoleucine]]	[[Katanosin]],[[Mupirocin]],
[[Isomer]]	[[Nonribosomal_Peptide]],[[Vinyldithiin]],
[[Isomigrastatin]]	[[Streptomyces_Isolates]],
[[Isoniazid]]	[[Thiocarlide]],[[4-Aminosalicylic_Acid]],[[List_Of_Antibiotics]],[[Template:Antimycobacterials]],[[Ethionamide]],[[Furonazide]],[[Ethambutol]],[[Thioacetazone]],[[Antibiotic_Resistance]],[[Platensimycin]],[[Antibiotic_Resistance]],
[[Isonicotinamide]]	[[Isoniazid]],
[[Isonicotinic_Acid]]	[[Isoniazid]],
[[Isopentenyl_Pyrophosphate]]	[[Platensimycin]],
[[Isoprenoid]]	[[Fosmidomycin]],
[[Isoprenyl_Pyrophosphate]]	[[List_Of_Antibiotics]],
[[Isothiocyanate]]	[[Cruciferous_Vegetables]],[[Cruciferous_Vegetables]],
[[Isotope]]	[[Platensimycin]],
[[Isotretinoin]]	[[Dapsone]],
[[Isoxazole]]	[[Template:Antimycobacterials]],
[[It:Verdure_Crocifere]]	[[Cruciferous_Vegetables]],
[[Itaconic_Acid]]	[[Medicinal_Molds]],
[[Italy]]	[[Clofoctol]],
[[Ivermectin]]	[[Streptomyces_Isolates]],
[[Ivory_Coast]]	[[Nifuroxazide]],
[[J_Antimicrob_Chemother]]	[[Daptomycin]],
[[Jacob_Volhard]]	[[Pulvinone]],[[Pulvinone]],
[[Japan]]	[[Arsphenamine]],
[[Jasmonic_Acid]]	[[Phytoalexin]],
[[Jaundice]]	[[Nitrofurantoin]],[[Daptomycin]],[[List_Of_Antibiotics]],[[Nitrofurantoin]],[[Dapsone]],
[[Jean_Paul_Vuillemin]]	[[Antibiotics]],
[[Jellyfish]]	[[Hydramacin-1]],
[[Joseph_Rapoport]]	[[Gramicidin_S]],
[[Joshua_Lederberg]]	[[Antibiotic_Resistance]],
[[Journal_Of_Antibiotic_Chemotherapy]]	[[Pyocyanin]],
[[Journal_Of_Antimicrobial_Chemotherapy]]	[[Lipopeptide]],[[Subtherapeutic_Antibiotic_Use_In_Swine]],
[[Journal_Of_Bacteriology]]	[[Pyocyanin]],[[Pyocyanin]],[[Pyocyanin]],
[[Journal_Of_Biological_Chemistry]]	[[Pyocyanin]],[[(6S)-6-Fluoroshikimic_Acid]],
[[Journal_Of_Biomedicine_And_Biotechnology]]	[[Salinomycin]],
[[Journal_Of_Clinical_Pathology]]	[[Pyocyanin]],
[[Journal_Of_Equine_Veterinary_Science]]	[[Monensin]],
[[Journal_Of_Microbiology]]	[[Albomycin]],
[[Journal_Of_Natural_Products]]	[[Glycyrrhizol]],
[[Journal_Of_The_American_Chemical_Society]]	[[Gramicidin_S]],
[[Jurkat_Cells]]	[[A23187]],
[[K252a]]	[[Medicinal_Molds]],[[Staurosporine]],
[[K252c]]	[[Staurosporine]],
[[KCNA3]]	[[Clofazimine]],
[[Kale]]	[[Cruciferous_Vegetables]],
[[Kanamycin]]	[[Antibiotic_Resistance]],[[List_Of_Antibiotics]],[[Template:Antimycobacterials]],
[[Kantrex]]	[[List_Of_Antibiotics]],
[[Karl_Maramorosch]]	[[Albert_Schatz_(scientist)]],
[[Kasugamycin]]	[[Albomycin]],
[[Kedarcidin]]	[[Neocarzinostatin]],
[[Keflex]]	[[List_Of_Antibiotics]],
[[Keflin]]	[[List_Of_Antibiotics]],
[[Kerala]]	[[Clofazimine]],
[[Ketek]]	[[List_Of_Antibiotics]],
[[Ketolide]]	[[Solithromycin]],[[Solithromycin]],[[Solithromycin]],[[Platensimycin]],
[[Ketone]]	[[Bottromycin]],
[[Kidney]]	[[Daptomycin]],[[Dapsone]],[[Fosfomycin]],[[Tanespimycin]],[[4-Aminosalicylic_Acid]],
[[Klebsiella]]	[[Nitrofurantoin]],[[Trimethoprim]],[[List_Of_Antibiotics]],[[Nitrofurantoin]],
[[Klebsiella_Oxytoca]]	[[Hydramacin-1]],
[[Kohlrabi]]	[[Cruciferous_Vegetables]],
[[Komatsuna]]	[[Cruciferous_Vegetables]],
[[Korean_Bell_Of_Friendship]]	[[Medicinal_Mushroom]],
[[Kuwait]]	[[Antibiotic_Resistance]],
[[Kynapcin]]	[[Medicinal_Mushroom]],[[Medicinal_Mushroom]],
[[LDL]]	[[Avenanthramide]],
[[Lachrymator]]	[[Allyl_Isothiocyanate]],
[[Lactam]]	[[Nonribosomal_Peptide]],[[Macbecin]],
[[Lactate_Dehydrogenase]]	[[Daptomycin]],
[[Lactobacillus]]	[[Bambermycin]],
[[Lactobacillus_Reuteri]]	[[Reuterin]],
[[Lactone]]	[[Pulvinone]],[[Pulvinone]],[[Nonribosomal_Peptide]],[[Carbomycin]],
[[Lamellarin_D]]	[[Topoisomerase_Inhibitor]],
[[Land_Cress]]	[[Cruciferous_Vegetables]],
[[Landomycin]]	[[Landomycinone]],
[[Lanostane]]	[[Medicinal_Mushroom]],
[[Larch_Bolete]]	[[Pulvinone]],[[Pulvinone]],
[[Latamoxef]]	[[Oxacephem]],[[Antibiotics]],
[[Latitude]]	[[Endiandric_Acid_C]],
[[Lauraceae]]	[[Endiandric_Acid_C]],
[[Lead_Compound]]	[[Arsphenamine]],[[Neosalvarsan]],
[[Leaving_Group]]	[[Tyrocidine]],
[[Leech]]	[[Hydramacin-1]],
[[Legionella_Pneumophila]]	[[Fusidic_Acid]],
[[Lentinan]]	[[Medicinal_Mushroom]],[[Medicinal_Mushroom]],
[[Lentinula_Edodes]]	[[Medicinal_Mushroom]],[[Medicinal_Mushroom]],
[[Lepidium_Campestre]]	[[Cruciferous_Vegetables]],
[[Leprostatic_Agent]]	[[Template:Antimycobacterials]],[[List_Of_Antibiotics]],[[List_Of_Antibiotics]],
[[Leprosy]]	[[Promin]],[[Clofazimine]],[[Ansamycin]],[[Dapsone]],[[Prothionamide]],
[[Leucine]]	[[Katanosin]],[[Gramicidin_S]],[[Surfactin]],
[[Leukaemia]]	[[MC21-B]],
[[Leukemia]]	[[Tanespimycin]],
[[Leukocytosis]]	[[Daptomycin]],
[[Leuna]]	[[Hexamethylenetetramine]],
[[Levaquin]]	[[List_Of_Antibiotics]],
[[Levofloxacin]]	[[Solithromycin]],[[Broad-spectrum_Antibiotic]],[[List_Of_Antibiotics]],
[[LexA]]	[[Antibiotic_Resistance]],
[[Lexitropsin]]	[[Netropsin]],
[[Lhasa]]	[[Medicinal_Mushroom]],
[[Lichen]]	[[Pulvinone]],
[[Lichen_Planus]]	[[Dapsone]],
[[Lichens]]	[[Medicinal_Mushroom]],
[[Licorice]]	[[Glycyrrhizol]],
[[Ligand_(biochemistry)]]	[[Efflux_(microbiology)]],
[[Lignosus]]	[[Medicinal_Mushroom]],
[[Lincomycin]]	[[List_Of_Antibiotics]],[[Streptomyces_Isolates]],
[[Lincosamides]]	[[Antibiotics]],[[Bacteriostatic_Agent]],[[List_Of_Antibiotics]],
[[Lindlar_Catalyst]]	[[Endiandric_Acid_C]],
[[Linear_Immunoglobulin_A_Dermatosis]]	[[Dapsone]],
[[Linezolid]]	[[Taksta]],[[Bottromycin]],[[Pristinamycin]],[[Template:Antimycobacterials]],[[Antibiotics]],[[Antibiotic_Resistance]],[[NXL103]],[[Platensimycin]],[[List_Of_Antibiotics]],[[Antibiotic_Resistance]],[[Antibiotic_Resistance]],
[[Linopristin]]	[[NXL103]],
[[Lipiarmycin]]	[[Myxopyronin]],[[Antibiotics]],[[Antibiotics]],
[[Lipid]]	[[Lipopeptide]],[[Vinyldithiin]],
[[Lipid_A]]	[[Ceragenin]],
[[Lipids]]	[[AGG01]],[[Vinyldithiin]],
[[Lipitor]]	[[Fusidic_Acid]],
[[Lipoglycopeptide]]	[[Telavancin]],
[[Lipopeptide]]	[[Daptomycin]],[[List_Of_Antibiotics]],[[Surfactin]],[[Friulimicin]],
[[Lipopeptides]]	[[Antibiotics]],
[[Lipophilic]]	[[Lipoglycopeptide]],[[Platensimycin]],
[[Lipophilicity]]	[[Triclosan]],
[[Lipopolysaccharide]]	[[Surfactin]],[[Trichostatin_A]],
[[Lipopolysaccharides]]	[[Arenicin]],
[[Lipoprotein]]	[[Allicin]],
[[Liposome]]	[[Staurosporine]],
[[Liposomes]]	[[A23187]],
[[List_Of_Antibiotics]]	[[Bacteriostatic_Agent]],
[[List_Of_Fermented_Soy_Products]]	[[Streptomyces_Isolates]],
[[List_Of_Microorganisms_Used_In_Food_And_Beverage_Preparation]]	[[Medicinal_Molds]],
[[List_Of_Nucleic_Acid_Simulation_Software]]	[[Netropsin]],
[[List_Of_Phytochemicals_In_Food]]	[[Allicin]],
[[Listeria_Monocytogenes]]	[[Reuterin]],
[[Lisuride]]	[[Medicinal_Molds]],[[Medicinal_Mushroom]],
[[Liter]]	[[Surfactin]],
[[Liver]]	[[Nitrofurantoin]],[[Dapsone]],[[4-Aminosalicylic_Acid]],[[Clofazimine]],
[[Liver_Cancer]]	[[Neocarzinostatin]],
[[Liver_Function_Test]]	[[Dapsone]],[[Daptomycin]],
[[Liver_Function_Tests]]	[[Isoniazid]],
[[Livestock]]	[[Animal_Drug_Availability_Act_1996]],
[[Lomefloxacin]]	[[List_Of_Antibiotics]],
[[Lorabid]]	[[List_Of_Antibiotics]],
[[Loracarbef]]	[[List_Of_Antibiotics]],
[[Louis_Pasteur]]	[[Antibiotics]],[[Antibiotics]],[[Pyocyanase]],
[[Louise_Slaughter]]	[[Antibiotic_Resistance]],
[[Lovastatin]]	[[Medicinal_Mushroom]],[[Endiandric_Acid_C]],[[Medicinal_Mushroom]],[[Medicinal_Molds]],[[Medicinal_Mushroom]],[[Medicinal_Molds]],[[Medicinal_Mushroom]],[[Medicinal_Mushroom]],
[[Lower_Respiratory_Tract_Infection]]	[[List_Of_Antibiotics]],
[[Lucilia_Sericata]]	[[Seraticin]],
[[Ludwig_Claisen]]	[[Pulvinone]],
[[Lugworm]]	[[Arenicin]],
[[Lumisterol]]	[[Medicinal_Mushroom]],
[[Lung]]	[[Dapsone]],
[[Lyme_Disease]]	[[List_Of_Antibiotics]],[[List_Of_Antibiotics]],[[List_Of_Antibiotics]],
[[Lymph_Nodes]]	[[Clofazimine]],
[[Lymphocytes]]	[[Pyocyanin]],
[[Lymphoma]]	[[A23187]],
[[Lysenkoism]]	[[Gramicidin_S]],
[[Lysergic_Acid]]	[[Medicinal_Molds]],
[[Lysergic_Acid_Diethylamide]]	[[Medicinal_Molds]],
[[Lysergic_Acid_Hydroxyethylamide]]	[[Medicinal_Molds]],
[[Lysine]]	[[AGG01]],
[[Lysins]]	[[Enzybiotics]],[[Enzybiotics]],
[[Lysis]]	[[Antibiotic_Resistance]],[[Surfactin]],[[Hitachimycin]],
[[Lysobacter]]	[[Katanosin]],
[[Lysosome]]	[[Cathelicidin]],
[[Lysosomes]]	[[Cathelicidin]],
[[MEROPS]]	[[Puromycin]],
[[MRNA]]	[[Blasticidin_S]],[[Puromycin]],
[[MRNA_Display]]	[[Puromycin]],
[[MRNA_Translation]]	[[List_Of_Antibiotics]],
[[MRSA]]	[[Bottromycin]],[[Antibiotics]],[[Bottromycin]],
[[MT81]]	[[Medicinal_Molds]],
[[MTB]]	[[Fosmidomycin]],
[[Maca]]	[[Cruciferous_Vegetables]],
[[Macin_Protein_Family]]	[[Hydramacin-1]],[[Hydramacin-1]],
[[Macrobid]]	[[List_Of_Antibiotics]],
[[Macrocycle]]	[[Macbecin]],
[[Macrocyclic_Compound]]	[[Roseophilin]],
[[Macrodantin]]	[[List_Of_Antibiotics]],
[[Macrolide]]	[[Platensimycin]],[[Antibiotic_Resistance]],[[Carbomycin]],[[Antibiotic_Misuse]],[[List_Of_Antibiotics]],[[Solithromycin]],[[Antibiotics]],[[Pristinamycin]],[[Erythromycin/sulfafurazole]],[[NXL103]],[[Bafilomycin]],
[[Macrolides]]	[[Bacteriostatic_Agent]],
[[Macromolecular]]	[[Neocarzinostatin]],
[[Macromomycin_B]]	[[Neocarzinostatin]],
[[Macrophage]]	[[Cathelicidin]],[[Gliotoxin]],[[Cathelicidin]],[[Cathelicidin]],
[[Macrophages]]	[[Antibiotics]],
[[Maduropeptin]]	[[Kedarcidin]],[[Neocarzinostatin]],[[Kedarcidin]],[[Kedarcidin]],
[[Mafenide]]	[[List_Of_Antibiotics]],
[[Magic_Bullet]]	[[Arsphenamine]],
[[Magnaporthe_Grisea]]	[[Phytoalexin]],
[[Maize]]	[[Beauvericin]],
[[Major_Facilitator_Superfamily]]	[[Efflux_(microbiology)]],
[[Malaria]]	[[Promin]],[[Alliance_For_The_Prudent_Use_Of_Antibiotics]],[[List_Of_Antibiotics]],[[Alliance_For_The_Prudent_Use_Of_Antibiotics]],[[Fosmidomycin]],[[Monensin]],[[Dapsone]],[[Fosmidomycin]],
[[Malaria_Parasites]]	[[Fosmidomycin]],
[[Malnutrition]]	[[Isoniazid]],
[[Malonate]]	[[Platensimycin]],
[[Malonyl_CoA]]	[[Endiandric_Acid_C]],
[[Mammal]]	[[Beauvericin]],
[[Mammals]]	[[Cathelicidin]],
[[Mammary_Gland]]	[[Cruciferous_Vegetables]],
[[Mandelic_Acid]]	[[Hexamethylenetetramine]],
[[Mandol]]	[[List_Of_Antibiotics]],
[[Manganese]]	[[4-Aminosalicylic_Acid]],
[[Mannan]]	[[Thiolutin]],
[[Mannich_Reaction]]	[[Bottromycin]],
[[Mannose]]	[[Actaplanin]],
[[Many_Farms,_Arizona]]	[[Isoniazid]],
[[Margaret_Thatcher]]	[[Gramicidin_S]],
[[Maria_Brazhnikova]]	[[Gramicidin_S]],
[[Marine_Biology]]	[[Streptomyces_Isolates]],
[[Marmite]]	[[Medicinal_Mushroom]],[[Medicinal_Molds]],
[[Martin_Khor]]	[[Antibiotic_Resistance]],
[[Martin_Sulfurane]]	[[Kedarcidin]],
[[Martindale:_The_Complete_Drug_Reference]]	[[Pristinamycin]],
[[Mass_Spectrometry]]	[[User:Harmonslide/sandbox]],[[Arsphenamine]],[[Kedarcidin]],[[Surfactin]],
[[Massachusetts_Institute_Of_Technology]]	[[Salinomycin]],
[[Mast_Cells]]	[[Avenanthramide]],
[[Mastitis]]	[[Thiostrepton]],
[[Matrix_Metalloproteinase]]	[[Medicinal_Mushroom]],
[[Mavelikara]]	[[Clofazimine]],
[[Mavroneri]]	[[Calicheamicin]],
[[Maxipime]]	[[List_Of_Antibiotics]],
[[Mayo_Clinic]]	[[Antibiotic_Misuse]],[[Promin]],[[Antibiotics]],
[[Mechanism_Of_Action]]	[[Salinomycin]],[[Bambermycin]],
[[Mecillinam]]	[[Extended-spectrum_Penicillin]],
[[Median_Lethal_Dose]]	[[Furonazide]],
[[Medical_Research_Council_(UK)]]	[[4-Aminosalicylic_Acid]],
[[Medication]]	[[Arsphenamine]],[[Kanamycin]],[[Tanespimycin]],
[[Medicinal_Chemistry]]	[[Antibiotics]],
[[Medicinal_Molds]]	[[Medicinal_Mushroom]],[[Streptomyces_Isolates]],
[[Medicinal_Mushrooms]]	[[Medicinal_Molds]],
[[Medicine]]	[[Broad-spectrum_Antibiotic]],[[Broad-spectrum_Antibiotic]],[[Antibiotics]],
[[Mediterranean]]	[[Vinyldithiin]],
[[Medscape]]	[[Erythromycin/sulfafurazole]],
[[Mefoxin]]	[[List_Of_Antibiotics]],
[[Megaloblastic_Anemia]]	[[Trimethoprim]],
[[Meir_Wilchek]]	[[Allicin]],[[Allicin]],[[Allicin]],
[[Melaleuca]]	[[Melafix]],[[Melafix]],
[[Melaleuca_Leucadendra]]	[[Melafix]],
[[Melanin]]	[[Medicinal_Mushroom]],
[[Melting_Point]]	[[Dalfopristin]],
[[Membranous_Glomerulonephritis]]	[[Hexamethylenetetramine]],
[[Memory_Consolidation]]	[[Cycloserine]],
[[Meningitis]]	[[Broad-spectrum_Antibiotic]],[[List_Of_Antibiotics]],[[Antibiotic_Resistance]],[[Daptomycin]],
[[Mercaptoacetic_Acid]]	[[Raphanin]],
[[Merck_Index]]	[[Thiostrepton]],
[[Mercury_(element)]]	[[Arsphenamine]],
[[Meropenem]]	[[Broad-spectrum_Antibiotic]],[[List_Of_Antibiotics]],
[[Merrem]]	[[List_Of_Antibiotics]],
[[Mesalazine]]	[[4-Aminosalicylic_Acid]],[[4-Aminosalicylic_Acid]],
[[Messenger_RNA]]	[[Nonribosomal_Peptide]],
[[Mesylate]]	[[Dalfopristin]],
[[Meta_Analysis]]	[[Nitrofurantoin]],
[[Metabolism]]	[[Neosalvarsan]],[[Bacteriostatic_Agent]],[[Thymineless_Death]],
[[Metabolite]]	[[Leptomycin]],[[Platensimycin]],
[[Metallopeptidase]]	[[Puromycin]],
[[Methanol]]	[[Kendomycin]],[[Triclosan]],
[[Methemoglobinemia]]	[[Dapsone]],[[Dapsone]],
[[Methenamine_Silver_Stain]]	[[Hexamethylenetetramine]],
[[Methicillin]]	[[List_Of_Antibiotics]],[[Bottromycin]],[[TAN-1057_C]],[[TAN-1057_A]],[[Antibiotic_Resistance]],
[[Methimazole]]	[[Ethionamide]],
[[Methionine]]	[[Nucleic_Acid_Inhibitor]],
[[Methotrexate]]	[[Thymineless_Death]],
[[Methyl]]	[[Carbomycin]],
[[Methyl_Group]]	[[Narasin]],
[[Methylation]]	[[Nonribosomal_Peptide]],[[Gramicidin_S]],
[[Methylene_Bridge]]	[[Hexamethylenetetramine]],
[[Methylenomycin_A]]	[[Methylenomycin_B]],
[[Methylenomycin_B]]	[[Methylenomycin_A]],
[[Methylergometrine]]	[[Medicinal_Mushroom]],[[Medicinal_Molds]],
[[Methyltransferase]]	[[Echinomycin]],[[Kedarcidin]],
[[Methysergide]]	[[Medicinal_Molds]],[[Medicinal_Mushroom]],
[[Metronidazole]]	[[List_Of_Antibiotics]],[[Antibiotics]],[[Nucleic_Acid_Inhibitor]],[[Antibiotics]],[[Template:Antimycobacterials]],
[[Mevastatin]]	[[Medicinal_Molds]],
[[Mezlocillin]]	[[List_Of_Antibiotics]],[[Extended-spectrum_Penicillin]],
[[Micafungin]]	[[Medicinal_Molds]],[[Medicinal_Mushroom]],
[[Micella]]	[[Surfactin]],
[[Micelles]]	[[Surfactin]],[[Surfactin]],
[[Micococcus_Luteus]]	[[Endiandric_Acid_C]],
[[Microbe]]	[[Dapsone]],
[[Microbiological_Culture]]	[[Production_Of_Antibiotics]],
[[Microbiologist]]	[[Albert_Schatz_(scientist)]],
[[Microbiology]]	[[Albert_Schatz_(scientist)]],[[Albert_Schatz_(scientist)]],
[[Micrococcus]]	[[Furazolidone]],
[[Microcystin]]	[[Nonribosomal_Peptide]],
[[Micromonospora_Echinospora]]	[[Calicheamicin]],
[[Microorganism]]	[[Phytoalexin]],[[Katanosin]],[[Production_Of_Antibiotics]],[[Nonribosomal_Peptide]],[[Multidrug_Tolerance]],[[Antibiotics]],[[Allistatin]],[[Antibiotic_Resistance]],[[Production_Of_Antibiotics]],
[[Microorganisms]]	[[Hexamethylenetetramine]],
[[Midostaurin]]	[[Streptomyces_Isolates]],[[Staurosporine]],[[Staurosporine]],
[[Migrastatin]]	[[Streptomyces_Isolates]],
[[Milbemycin]]	[[Streptomyces_Isolates]],
[[Milbemycin_Oxime]]	[[Streptomyces_Isolates]],
[[Milk_Production]]	[[Delvotest]],
[[Ming_Dynasty]]	[[Medicinal_Mushroom]],
[[Minimum_Bactericidal_Concentration]]	[[Antimicrobial_Pharmacodynamics]],[[Allicin]],
[[Minimum_Inhibitory_Concentration]]	[[Raphanin]],[[Fusidic_Acid]],[[Antimicrobial_Pharmacodynamics]],[[Antibiotics]],[[Allicin]],[[Ethionamide]],[[Nitrofurantoin]],[[Antibiotic_Sensitivity]],[[Furazolidone]],[[Gramicidin_S]],[[Bottromycin]],
[[Ministry_Of_Health_(Soviet_Union)]]	[[Gramicidin_S]],
[[Ministry_Of_Public_Health_(Thailand)]]	[[Nitrofurantoin]],
[[Minocin]]	[[List_Of_Antibiotics]],
[[Minocycline]]	[[List_Of_Antibiotics]],
[[Minor_Groove]]	[[Calicheamicin]],[[Netropsin]],
[[Mitomycin_C]]	[[Streptomyces_Isolates]],
[[Mitotic_Inhibitor]]	[[Medicinal_Molds]],
[[Mitoxantrone]]	[[Topoisomerase_Inhibitor]],
[[Mizoribine]]	[[Medicinal_Mushroom]],
[[Mizuna]]	[[Cruciferous_Vegetables]],
[[Mobile_Genetic_Elements]]	[[Antibiotic_Resistance]],
[[Mode_Of_Action]]	[[Arenicin]],
[[Molar_(concentration)]]	[[Reuterin]],
[[Mold]]	[[Reuterin]],[[Antibiotics]],
[[Molds]]	[[Medicinal_Mushroom]],
[[Mole_(unit)]]	[[Dapsone]],[[Hitachimycin]],[[Brilacidin]],[[Platensimycin]],
[[Molecular_Cancer_Research]]	[[Thiostrepton]],
[[Molecular_Dynamics]]	[[Bottromycin]],
[[Molecular_Mass]]	[[Archaeocin]],[[Gramicidin_S]],[[Platensimycin]],
[[Molecular_Pharmaceutics]]	[[Clofazimine]],
[[Molecular_Weight]]	[[Antibiotics]],
[[Molecule]]	[[Lipopeptide]],[[Surfactin]],
[[Monacolin_J]]	[[Medicinal_Molds]],
[[Monascus_Purpureus]]	[[Medicinal_Molds]],[[Medicinal_Molds]],
[[Monensin]]	[[Nigericin]],
[[Monensin_A_Methyl_Ester]]	[[Monensin]],
[[Monobactams]]	[[List_Of_Antibiotics]],
[[Monoclonal_Antibodies]]	[[Calicheamicin]],
[[Monolayer]]	[[Medicinal_Molds]],
[[Monomer]]	[[Pulvinone]],
[[Monoxycarbolic_Acid]]	[[Mupirocin]],
[[Moraxella]]	[[Fusidic_Acid]],
[[Moraxella_Catarrhalis]]	[[Trimethoprim]],
[[Morchella_Esculenta]]	[[Medicinal_Mushroom]],
[[Morganella_(bacterium)]]	[[Trimethoprim]],
[[Morinamide]]	[[Template:Antimycobacterials]],
[[Mould]]	[[Pulvinone]],[[Pulvinone]],[[Pulvinone]],
[[Mouth]]	[[Antibiotics]],
[[Mouth_Infections]]	[[List_Of_Antibiotics]],
[[Mouth_Wash]]	[[Triclosan]],
[[Moxalactam]]	[[Oxacephem]],
[[Moxidectin]]	[[Streptomyces_Isolates]],
[[Moxifloxacin]]	[[List_Of_Antibiotics]],[[Antibiotic_Misuse]],[[Broad-spectrum_Antibiotic]],
[[Mucor]]	[[Fusidic_Acid]],
[[Mucous_Membranes]]	[[Antibiotic_Resistance]],
[[Multi_Antimicrobial_Extrusion_Protein]]	[[Efflux_(microbiology)]],
[[Multi_Drug_Resistant]]	[[List_Of_Antibiotics]],
[[Multidrug_Resistance]]	[[Arenicin]],[[Antibiotic_Resistance]],[[Multidrug_Tolerance]],
[[Multidrug_Resistant]]	[[Antibiotic_Resistance]],
[[Multidrug_Tolerance]]	[[Antibiotic_Tolerance]],[[Persister_Cell]],[[Antibiotic_Resistance]],
[[Multiple_Myeloma]]	[[Salinosporamide_A]],
[[Multiple_Sclerosis]]	[[Clofazimine]],[[Myriocin]],
[[Multiresistant]]	[[Plectasin]],
[[Mupirocin]]	[[List_Of_Antibiotics]],
[[Murine]]	[[Arenicin]],
[[Mushrooms]]	[[Medicinal_Mushroom]],
[[Mustard_(condiment)]]	[[Allyl_Isothiocyanate]],
[[Mustard_Oil]]	[[Allyl_Isothiocyanate]],
[[Mustard_Plant]]	[[Allicin]],
[[Mustard_Seed]]	[[Cruciferous_Vegetables]],[[Allyl_Isothiocyanate]],
[[Mutagen]]	[[Production_Of_Antibiotics]],
[[Mutant]]	[[Efflux_(microbiology)]],[[Platensimycin]],[[Multidrug_Tolerance]],
[[Mutase]]	[[Kedarcidin]],
[[Mutation]]	[[Mupirocin]],[[Antibiotic_Resistance]],[[Arenicin]],[[Production_Of_Antibiotics]],[[Plectasin]],
[[Mutations]]	[[Ristocetin]],
[[Myalgia]]	[[Daptomycin]],[[Daptomycin]],
[[Mycelia]]	[[Medicinal_Mushroom]],
[[Mycelia_Sterilia]]	[[Myriocin]],
[[Mycelium]]	[[Streptomyces_Isolates]],[[Medicinal_Mushroom]],
[[Mycobacteria]]	[[Thiocarlide]],[[Beauvericin]],[[List_Of_Antibiotics]],[[Tobramycin/dexamethasone]],[[List_Of_Antibiotics]],
[[Mycobacterium]]	[[Isoniazid]],[[Isoniazid]],
[[Mycobacterium_Avium]]	[[Clofazimine]],
[[Mycobacterium_Avium_Complex]]	[[Ethambutol]],[[Ethambutol]],
[[Mycobacterium_Avium_Paratuberculosis]]	[[Clofazimine]],
[[Mycobacterium_Kansasii]]	[[Ethambutol]],[[Ethambutol]],
[[Mycobacterium_Leprae]]	[[Promin]],[[Dapsone]],[[Fusidic_Acid]],
[[Mycobacterium_Tuberculosis]]	[[Ethionamide]],[[Antibiotic_Resistance]],[[Thioacetazone]],[[Antibiotic_Resistance]],[[Fusidic_Acid]],[[Isoniazid]],[[Promin]],[[Cycloserine]],
[[Mycofiltration]]	[[Medicinal_Molds]],
[[Mycolic_Acid]]	[[Template:Antimycobacterials]],[[Isoniazid]],[[Template:Antimycobacterials]],[[Ethambutol]],[[Ethionamide]],
[[Mycophenolic_Acid]]	[[Medicinal_Mushroom]],[[Medicinal_Molds]],
[[Mycoplasma]]	[[Carbomycin]],[[Bottromycin]],[[Surfactin]],
[[Mycoplasmal_Infection]]	[[List_Of_Antibiotics]],[[List_Of_Antibiotics]],[[List_Of_Antibiotics]],
[[Mycoprotein]]	[[Medicinal_Mushroom]],
[[Mycoremediation]]	[[Medicinal_Molds]],
[[Mycorrhiza]]	[[Medicinal_Molds]],[[Medicinal_Mushroom]],
[[Mycorrhizal]]	[[Medicinal_Mushroom]],[[Medicinal_Mushroom]],[[Medicinal_Mushroom]],
[[Mycosis]]	[[Tobramycin/dexamethasone]],
[[Mycotoxin]]	[[Gliotoxin]],
[[Mycotoxins]]	[[Pyrenocine]],
[[Myelination]]	[[Medicinal_Mushroom]],
[[Myeloperoxidase]]	[[Dapsone]],
[[Myocardial_Infarction]]	[[Vinyldithiin]],
[[Myocet]]	[[Streptomyces_Isolates]],
[[Myopathy]]	[[Daptomycin]],
[[Myositis]]	[[Daptomycin]],
[[Myriocin]]	[[Medicinal_Molds]],
[[Myrosinase]]	[[Allyl_Isothiocyanate]],
[[Myxobolus_Cerebralis]]	[[Furazolidone]],
[[Myxochelin_A]]	[[Nonribosomal_Peptide]],
[[Myxopyronin]]	[[Antibiotic_Resistance]],
[[NADH]]	[[Isoniazid]],[[Novobiocin]],
[[NADPH:quinone_Reductase]]	[[Cruciferous_Vegetables]],
[[NADPH]]	[[Pyocyanin]],[[Novobiocin]],[[Novobiocin]],
[[NADPH_Oxidase]]	[[Pyocyanin]],
[[NIH]]	[[Fosfomycin/tobramycin]],
[[NMDA_Receptor]]	[[Cycloserine]],
[[NMR]]	[[Kedarcidin]],
[[NSAID]]	[[Dapsone]],
[[NXL103]]	[[Linopristin]],
[[NXL_103]]	[[Streptogramin]],
[[Nafcillin]]	[[List_Of_Antibiotics]],[[Daptomycin]],
[[Nalidixic_Acid]]	[[List_Of_Antibiotics]],
[[Nanoparticle]]	[[Efflux_(microbiology)]],[[Triclosan]],[[Staurosporine]],
[[Nanoparticles]]	[[Medicinal_Molds]],
[[Naphthalene]]	[[Ansamycin]],
[[Naphthoic_Acid]]	[[Kedarcidin]],
[[Naphthomycin]]	[[Naphthomycin_A]],[[Ansamycin]],
[[Naphthoquinone]]	[[Ansamycin]],
[[Narasin]]	[[Salinomycin]],
[[Nares]]	[[Mupirocin]],
[[Natamycin]]	[[Streptomyces_Isolates]],
[[National_Institute_Of_Allergy_And_Infectious_Diseases]]	[[Alliance_For_The_Prudent_Use_Of_Antibiotics]],
[[National_Institutes_Of_Health]]	[[Antibiotics]],[[Allicin]],[[Antibiotic_Resistance]],
[[Natural_Anthraquinone]]	[[Chromomycin_A3]],
[[Natural_Growth_Promoter]]	[[Antibiotic_Misuse]],
[[Natural_Phenol]]	[[Topoisomerase_Inhibitor]],
[[Natural_Product]]	[[Katanosin]],[[User:Harmonslide/sandbox]],[[Pulvinone]],[[Staurosporine]],[[Enediyne]],
[[Natural_Resources_Defense_Council]]	[[Antibiotics]],[[Antibiotic_Resistance]],
[[Natural_Selection]]	[[Antibiotics]],[[Antibiotic_Resistance]],
[[Nature_(journal)]]	[[Gramicidin_S]],[[Triclosan]],[[Thiostrepton]],
[[Nature_Reviews_Microbiology]]	[[Resistome]],
[[Nausea]]	[[List_Of_Antibiotics]],[[Dapsone]],
[[Navajo_Nation]]	[[Isoniazid]],
[[Nazarov_Cyclization_Reaction]]	[[Roseophilin]],
[[Nebcin]]	[[List_Of_Antibiotics]],
[[Necrosis]]	[[Nitrofurantoin]],[[Pyocyanin]],
[[Necrotizing_Fasciitis]]	[[Antibiotic_Resistance]],
[[Neisseria]]	[[Fusidic_Acid]],
[[Neisseria_Gonorrhoeae]]	[[Efflux_(microbiology)]],[[Antibiotic_Resistance]],
[[Neisseria_Meningitidis]]	[[Trimethoprim]],
[[Neoaspergillic_Acid]]	[[Aspergillic_Acid]],
[[Neocarzinostatin]]	[[Kedarcidin]],[[Kedarcidin]],[[Esperamicin]],[[Enediyne]],[[Kedarcidin]],[[Kedarcidin]],
[[Neohydroxyaspergillic_Acid]]	[[Aspergillic_Acid]],
[[Neomycin]]	[[List_Of_Antibiotics]],[[Streptomyces_Isolates]],[[Thiostrepton]],[[Thiostrepton]],
[[Neosalvarsan]]	[[Arsphenamine]],
[[Neothramycin]]	[[Streptomyces_Isolates]],
[[Neoxaline]]	[[Medicinal_Molds]],
[[Nephrotoxicity]]	[[List_Of_Antibiotics]],
[[Nerve_Growth_Factor]]	[[Medicinal_Mushroom]],
[[Netilmicin]]	[[List_Of_Antibiotics]],
[[Netromycin]]	[[List_Of_Antibiotics]],
[[Netropsin]]	[[Kedarcidin]],
[[Neuraminidase]]	[[Medicinal_Mushroom]],
[[Neuropathy]]	[[Nitrofurantoin]],
[[Neurotoxicity]]	[[List_Of_Antibiotics]],
[[Neurotransmission]]	[[Cycloserine]],
[[Neurotransmitter]]	[[Cycloserine]],[[Cycloserine]],
[[Neurotrophic]]	[[Medicinal_Mushroom]],
[[Neutropenia]]	[[Antibiotics]],
[[Neutrophil]]	[[Dapsone]],[[Pyocyanin]],[[Gliotoxin]],
[[Neutrophils]]	[[Cathelicidin]],
[[New_England_Journal_Of_Medicine]]	[[Antibiotic_Resistance]],
[[New_Jersey_College_For_Women]]	[[Albert_Schatz_(scientist)]],
[[New_Latin]]	[[Cruciferous_Vegetables]],
[[New_Scientist]]	[[Antibiotic_Resistance]],[[Salinomycin]],[[Antibiotic_Resistance]],
[[New_York_Times]]	[[Antibiotic_Resistance]],
[[New_Zealand]]	[[Endiandric_Acid_C]],
[[Newton_(unit)]]	[[Surfactin]],
[[Nicergoline]]	[[Medicinal_Molds]],[[Medicinal_Mushroom]],
[[Nicotinamide_Adenine_Dinucleotide]]	[[Triclosan]],
[[Nicotinamide_Riboside]]	[[Medicinal_Molds]],[[Medicinal_Molds]],[[Medicinal_Mushroom]],
[[Nicotinic_Acetylcholine_Receptor]]	[[Solithromycin]],
[[Nigericin]]	[[Salinomycin]],
[[Nigrospora_Oryzae]]	[[Aphidicolin]],
[[Nigrosporin_B]]	[[Medicinal_Molds]],
[[Ninhydrin]]	[[Bottromycin]],
[[Nitric_Acid]]	[[Hexamethylenetetramine]],
[[Nitric_Oxide]]	[[Isoniazid]],
[[Nitric_Oxide_Synthase]]	[[Trichostatin_A]],
[[Nitrile]]	[[Cruciferous_Vegetables]],
[[Nitrofuran]]	[[Nifuroxazide]],[[Furazolidone]],[[Nifurquinazol]],[[Nitrofurantoin]],[[Furazolidone]],
[[Nitrofurans]]	[[List_Of_Antibiotics]],
[[Nitrofurantoin]]	[[List_Of_Antibiotics]],[[Bacteriostatic_Agent]],[[Nucleic_Acid_Inhibitor]],
[[Nitrofurazone]]	[[Mupirocin]],[[Nitrofurantoin]],
[[Nitrogen]]	[[Platensimycin]],[[Nonribosomal_Peptide]],[[Nonribosomal_Peptide]],[[Polyoxins]],[[Hexamethylenetetramine]],[[Carbomycin]],
[[Nl:Kruisbloemige_Groenten]]	[[Cruciferous_Vegetables]],
[[Nobel_Lecture]]	[[Antibiotic_Resistance]],
[[Nobel_Prize]]	[[Gramicidin_S]],[[Dapsone]],
[[Nobel_Prize_Controversies]]	[[Albert_Schatz_(scientist)]],
[[Nobel_Prize_In_Medicine]]	[[Antibiotics]],
[[Nobel_Prize_In_Physiology_Or_Medicine]]	[[Antibiotics]],
[[Nodularin]]	[[Nonribosomal_Peptide]],
[[Noncovalent_Bonding]]	[[Kedarcidin]],
[[Nonribosomal_Peptide]]	[[Bottromycin]],[[Surfactin]],[[Tyrocidine]],
[[Norfloxacin]]	[[List_Of_Antibiotics]],
[[Norwich,_Connecticut]]	[[Albert_Schatz_(scientist)]],[[Albert_Schatz_(scientist)]],[[Albert_Schatz_(scientist)]],
[[Nosocomial]]	[[Antibiotic_Resistance]],
[[Nosocomial_Infection]]	[[Antibiotic_Resistance]],[[Antibiotic_Resistance]],
[[Nosocomial_Pneumonia]]	[[Telavancin]],
[[Novamox]]	[[List_Of_Antibiotics]],
[[Novartis]]	[[Clofazimine]],[[Daptomycin]],[[Clofazimine]],
[[Novobiocin]]	[[Aminocoumarin]],[[Bacteriostatic_Agent]],[[Aminocoumarin]],[[Aminocoumarin]],[[Aminocoumarin]],
[[Novozymes]]	[[Plectasin]],[[Arenicin]],
[[Nuclear_Export_Sequence]]	[[Leptomycin]],
[[Nuclear_Magnetic_Resonance]]	[[User:Harmonslide/sandbox]],[[Naphthomycin_A]],
[[Nuclear_Overhauser_Effect]]	[[Kedarcidin]],
[[Nucleic_Acid]]	[[Nucleic_Acid_Inhibitor]],[[Pluramycin_A]],[[Streptolydigin]],[[List_Of_Antibiotics]],[[Nucleic_Acid_Inhibitor]],[[Neopluramycin]],
[[Nucleic_Acid_Inhibitor]]	[[Template:Antimycobacterials]],[[Trimethoprim/polymyxin]],
[[Nucleic_Acids]]	[[Antibiotic_Resistance]],
[[Nucleic_Acids_Research]]	[[Nonribosomal_Peptide]],
[[Nucleobase]]	[[Esperamicin]],
[[Nucleophile]]	[[Platensimycin]],[[Staurosporine]],
[[Nucleoside]]	[[Polyoxins]],[[Tunicamycin]],
[[Nucleus_Accumbens]]	[[Cycloserine]],
[[Nudibranch]]	[[Nonribosomal_Peptide]],
[[Nutrient]]	[[Production_Of_Antibiotics]],[[Cruciferous_Vegetables]],
[[Nutritional_Yeast]]	[[Medicinal_Mushroom]],[[Medicinal_Molds]],
[[Nystatin]]	[[Thiostrepton]],[[Thiostrepton]],[[Streptomyces_Isolates]],
[[OIE]]	[[Antibiotic_Resistance]],
[[Oatmeal]]	[[Avenanthramide]],
[[Oats]]	[[Avenanthramide]],
[[Offspring]]	[[Multidrug_Tolerance]],
[[Ofloxacin]]	[[List_Of_Antibiotics]],[[Antibiotic_Misuse]],
[[Ointment]]	[[List_Of_Antibiotics]],[[Antibiotics]],[[Tobramycin/dexamethasone]],[[Fusidic_Acid]],
[[Old_Testament]]	[[Antibiotic_Resistance]],
[[Oleic_Acid]]	[[Thiocarlide]],
[[Oligodynamic_Effect]]	[[Bacteriostatic_Agent]],
[[Oligomers]]	[[Pulvinone]],
[[Oligopeptide]]	[[Thiostrepton]],
[[Omnicef]]	[[List_Of_Antibiotics]],
[[Omniflox]]	[[List_Of_Antibiotics]],
[[Omuralide]]	[[Salinosporamide_A]],
[[Oncogenesis]]	[[Geldanamycin]],[[Herbimycin]],
[[Onion]]	[[Allicin]],
[[Onions]]	[[Allistatin]],
[[Open_Reading_Frame]]	[[Kanamycin]],
[[Open_Reading_Frames]]	[[Tyrocidine]],
[[Operation_Enduring_Freedom]]	[[Antibiotic_Resistance]],
[[Operon]]	[[Nonribosomal_Peptide]],[[Spectinomycin]],[[Nonribosomal_Peptide]],
[[Ophiocordyceps_Sinensis]]	[[Medicinal_Mushroom]],
[[Ophthalmic]]	[[Nitrofurantoin]],
[[Opportunistic_Pathogen]]	[[Antibiotic_Resistance]],
[[Optic_Neuritis]]	[[Ethambutol]],
[[Optical_Rotation]]	[[Bottromycin]],
[[Oral_Administration]]	[[Ethionamide]],
[[Orange_Juice]]	[[4-Aminosalicylic_Acid]],
[[Organic_Compound]]	[[Isoniazid]],[[4-Aminosalicylic_Acid]],[[Triclosan]],[[Aspergillic_Acid]],[[Surfactin]],[[Pulvinone]],
[[Organic_Redox_Reaction]]	[[Platensimycin]],[[Aspergillic_Acid]],
[[Organic_Synthesis]]	[[Hexamethylenetetramine]],
[[Organism]]	[[Antibiosis]],
[[Organoarsenic_Chemistry]]	[[Arsphenamine]],
[[Organoarsenic_Compound]]	[[Neosalvarsan]],
[[Organon]]	[[Pulvinone]],
[[Organosulfur]]	[[Vinyldithiin]],
[[Organosulfur_Compound]]	[[Allyl_Isothiocyanate]],[[Allicin]],
[[Oritavancin]]	[[Lipoglycopeptide]],[[Lipoglycopeptide]],
[[Ornithine]]	[[Gramicidin_S]],[[Gramicidin_S]],[[Gramicidin_S]],
[[Orphan_Drug]]	[[Clofazimine]],
[[Osteomyelitis]]	[[Fusidic_Acid]],[[Daptomycin]],
[[Osteoporosis]]	[[Bafilomycin]],[[Kendomycin]],
[[Otitis_Media]]	[[Antibiotic_Misuse]],[[Antibiotic_Resistance]],[[Multidrug_Tolerance]],
[[Ototoxicity]]	[[List_Of_Antibiotics]],[[4-Aminosalicylic_Acid]],[[List_Of_Antibiotics]],
[[Oudemansin_A]]	[[Medicinal_Mushroom]],
[[Outer_Ear]]	[[Acetic_Acid/hydrocortisone]],
[[Overexpress]]	[[Triclosan]],
[[Oxacillin]]	[[Antibiotic_Resistance]],[[List_Of_Antibiotics]],[[Daptomycin]],
[[Oxaline]]	[[Medicinal_Molds]],
[[Oxazolidine]]	[[Nonribosomal_Peptide]],
[[Oxazolidinone]]	[[Antibiotics]],[[Bacteriostatic_Agent]],[[Antibiotics]],
[[Oxazoline]]	[[Nonribosomal_Peptide]],
[[Oxidation]]	[[Antimycin_A]],[[Mupirocin]],[[Dalfopristin]],
[[Oxidative_Phosphorylation]]	[[A23187]],
[[Oxyanion_Hole]]	[[Platensimycin]],
[[Oxygen]]	[[Carbomycin]],[[Mupirocin]],
[[Oxytetracycline]]	[[Broad-spectrum_Antibiotic]],[[List_Of_Antibiotics]],
[[P450_System]]	[[Isoniazid]],
[[P53]]	[[Geldanamycin]],[[Leptomycin]],[[Herbimycin]],
[[PBMC]]	[[Clofazimine]],
[[PCMX]]	[[Triclosan]],
[[PH]]	[[Reuterin]],[[Production_Of_Antibiotics]],
[[PH_Indicator]]	[[Actinorhodin]],
[[PKa]]	[[Dalfopristin]],
[[PNAS]]	[[Pyocyanin]],
[[Paclitaxel]]	[[Salinomycin]],[[Medicinal_Molds]],[[Medicinal_Molds]],[[Medicinal_Molds]],
[[Pan_American_Health_Organization]]	[[Alliance_For_The_Prudent_Use_Of_Antibiotics]],
[[Pancreatic_Cancer]]	[[Albert_Schatz_(scientist)]],
[[Pandemic_And_All_Hazards_Preparedness_Act]]	[[Antibiotic_Resistance]],
[[Pantethine]]	[[Nonribosomal_Peptide]],
[[Papaya]]	[[Phytoalexin]],
[[Paper_Chromatography]]	[[Bottromycin]],
[[Paprika]]	[[Efflux_(microbiology)]],
[[Paraesthesia]]	[[Daptomycin]],
[[Paranormal]]	[[Albert_Schatz_(scientist)]],
[[Parasitic_Diseases]]	[[Antibiotics]],
[[Parasitism]]	[[Melafix]],
[[Parathion]]	[[Arsphenamine]],
[[Paresis]]	[[Cycloserine]],
[[Paresthesias]]	[[Cycloserine]],
[[Paromomycin]]	[[List_Of_Antibiotics]],
[[Passaic,_New_Jersey]]	[[Albert_Schatz_(scientist)]],
[[Pasteur_Institute]]	[[Dapsone]],
[[Pasteurella_Multocida]]	[[Spectinomycin]],
[[Pathogen]]	[[Platensimycin]],[[Solithromycin]],[[Multidrug_Tolerance]],[[Antibiosis]],[[Antibiotic_Resistance]],
[[Pathogenic]]	[[Antibiotic_Resistance]],
[[Pathogenic_Bacteria]]	[[List_Of_Antibiotics]],
[[Pathogenic_Fungi]]	[[Multidrug_Tolerance]],
[[Pathogens]]	[[Arenicin]],
[[Pathologic_Nystagmus]]	[[Ethambutol]],
[[Paul_Ehrlich]]	[[Arsphenamine]],[[Neosalvarsan]],[[Antibiotics]],[[Dapsone]],
[[Pemphigoid]]	[[Dapsone]],[[Antibiotics]],
[[Penicillin]]	[[Antibiotic_Resistance]],[[AGG01]],[[Arsphenamine]],[[Antibiotic_Resistance]],[[Antibiotics]],[[Pyocyanase]],[[Antibiotic_Resistance]],[[Antibiotic_Resistance]],[[Antibiotics]],[[Antibiotics]],[[Medicinal_Molds]],[[List_Of_Antibiotics]],[[Antibiotics]],[[Cell_Envelope_Antibiotic]],[[Carbomycin]],[[Antibiotic_Resistance]],[[Medicinal_Mushroom]],[[Neosalvarsan]],[[Broad-spectrum_Antibiotic]],[[Broad-spectrum_Antibiotic]],[[Medicinal_Molds]],[[Antibiotics]],[[NXL103]],[[Production_Of_Antibiotics]],[[Antibiotic_Resistance]],[[Tyrocidine]],[[Spectinomycin]],
[[Penicillin_Binding_Protein]]	[[Antibiotic_Resistance]],
[[Penicillin_G]]	[[List_Of_Antibiotics]],[[Antibiotics]],[[List_Of_Antibiotics]],
[[Penicillin_V]]	[[List_Of_Antibiotics]],
[[Penicillinase]]	[[Antibiotic_Resistance]],
[[Penicillium]]	[[Citromycin]],[[Antibiotics]],[[Gliotoxin]],[[Yaequinolone_J1]],
[[Penicillium_Citrinum]]	[[Medicinal_Mushroom]],
[[Penicillium_Expansum]]	[[Questiomycin_A]],
[[Pentamer]]	[[Arsphenamine]],
[[Pentapeptide]]	[[Gramicidin_S]],
[[Pepducin]]	[[Lipopeptide]],
[[Peptide]]	[[Nonribosomal_Peptide]],[[Echinomycin]],[[Surfactin]],[[Plectasin]],[[Bottromycin]],[[Bottromycin]],[[Lipopeptide]],[[Puromycin]],[[AGG01]],[[User:Harmonslide/sandbox]],[[Archaeocin]],[[AGG01]],[[Gramicidin_S]],[[Gramicidin_S]],[[Peptaibol]],
[[Peptide_Sequence]]	[[Efflux_(microbiology)]],
[[Peptidoglycan]]	[[Template:Antimycobacterials]],[[Cycloserine]],[[List_Of_Antibiotics]],[[List_Of_Antibiotics]],[[Fosfomycin]],[[List_Of_Antibiotics]],[[List_Of_Antibiotics]],[[List_Of_Antibiotics]],[[List_Of_Antibiotics]],[[List_Of_Antibiotics]],[[List_Of_Antibiotics]],[[List_Of_Antibiotics]],[[Surfactin]],[[List_Of_Antibiotics]],[[Ramoplanin]],
[[Peptidyl_Carrier_Protein]]	[[Nonribosomal_Peptide]],
[[Pergolide]]	[[Medicinal_Molds]],[[Medicinal_Mushroom]],
[[Periodontitis]]	[[Antibiotics]],
[[Peripheral_Neuropathy]]	[[Ethambutol]],[[List_Of_Antibiotics]],[[Isoniazid]],[[Isoniazid]],[[Dapsone]],
[[Periplasmic_Space]]	[[Streptomyces_Isolates]],
[[Peritonitis]]	[[Antibiotic_Resistance]],
[[Pesticide_Resistance]]	[[Antibiotic_Resistance]],
[[Pet32a]]	[[Hydramacin-1]],
[[Petals]]	[[Cruciferous_Vegetables]],
[[Petri_Dish]]	[[Antibiotics]],
[[Peziza_Vesiculosa]]	[[Medicinal_Mushroom]],
[[Pezizales]]	[[Plectasin]],
[[Pfizer]]	[[Antibiotic_Resistance]],[[Carbomycin]],[[Ethionamide]],
[[Ph:pakrus_Gulay]]	[[Cruciferous_Vegetables]],
[[Phage_Therapy]]	[[Enzybiotics]],[[Antibiotic_Resistance]],
[[Phagosome]]	[[Cathelicidin]],
[[Phallus_Impudicus]]	[[Medicinal_Mushroom]],
[[Phallus_Indusiatus]]	[[Medicinal_Mushroom]],
[[Pharmaceutical]]	[[Neosalvarsan]],
[[Pharmaceutical_Chemistry_Journal]]	[[Isoniazid]],
[[Pharmaceutical_Drug]]	[[Trimethoprim/polymyxin]],
[[Pharmacia]]	[[Aminocoumarin]],[[Novobiocin]],
[[Pharmacokinetics]]	[[Antibiotics]],
[[Phases_Of_Clinical_Research]]	[[Antibiotics]],
[[Phellinin]]	[[Medicinal_Mushroom]],
[[Phellinstatin]]	[[Medicinal_Mushroom]],[[Medicinal_Mushroom]],
[[Phellinus_Linteus]]	[[Medicinal_Mushroom]],[[Medicinal_Mushroom]],[[Medicinal_Mushroom]],
[[Phenazine]]	[[Template:Antimycobacterials]],
[[Phenol]]	[[Triclosan]],
[[Phenolic_Resin]]	[[Hexamethylenetetramine]],
[[Phenotype]]	[[Multidrug_Tolerance]],
[[Phenylalanine]]	[[Gramicidin_S]],[[Pulvinone]],[[Katanosin]],[[Gramicidin_S]],[[Beauvericin]],
[[Phenylthiocarbamide]]	[[Cruciferous_Vegetables]],
[[Phenytoin]]	[[4-Aminosalicylic_Acid]],[[Isoniazid]],
[[Philadelphia]]	[[Albert_Schatz_(scientist)]],[[Albert_Schatz_(scientist)]],
[[Phlebitis]]	[[Fusidic_Acid]],
[[Phloretin]]	[[Efflux_(microbiology)]],
[[Pholiota_Nameko]]	[[Medicinal_Mushroom]],
[[Pholiota_Squarrosa]]	[[Medicinal_Mushroom]],
[[Phosphate]]	[[Fosfomycin]],
[[Phosphatidylglycerol]]	[[Daptomycin]],
[[Phosphodiester]]	[[Topoisomerase_Inhibitor]],
[[Phosphoenolpyruvate]]	[[Fosfomycin]],
[[Phospholipid]]	[[Surfactin]],
[[Phosphonic_Acid]]	[[Fosfomycin/tobramycin]],
[[Phosphopantetheine]]	[[Tyrocidine]],
[[Phosphoric_Acid]]	[[Nonribosomal_Peptide]],
[[Photochemistry]]	[[Medicinal_Mushroom]],
[[Photodermatitis]]	[[Antibiotics]],
[[Photosynthesis]]	[[Triclosan]],[[Antimycin_A]],
[[Phylum]]	[[Hydramacin-1]],
[[Physarum_Polycephalum]]	[[Medicinal_Molds]],
[[Physical_Chemistry]]	[[Efflux_(microbiology)]],
[[Phytoalexin]]	[[Avenanthramide]],[[Topoisomerase_Inhibitor]],
[[Phytochemical]]	[[Cruciferous_Vegetables]],
[[Phytochemicals]]	[[Medicinal_Mushroom]],[[Phytoalexin]],[[Vinyldithiin]],
[[Piceid]]	[[Medicinal_Molds]],
[[Pigment]]	[[Nonribosomal_Peptide]],[[Nonribosomal_Peptide]],
[[Pimecrolimus]]	[[Streptomyces_Isolates]],
[[Pinaceae]]	[[Phytoalexin]],
[[Pingyangmycin]]	[[Streptomyces_Isolates]],
[[Pinosylvin]]	[[Phytoalexin]],
[[Piperacillin]]	[[List_Of_Antibiotics]],[[Extended-spectrum_Penicillin]],
[[Piperine]]	[[Allyl_Isothiocyanate]],[[Allicin]],
[[Piptoporus_Betulinus]]	[[Medicinal_Mushroom]],
[[Pirarubicin]]	[[Streptomyces_Isolates]],
[[Piricularia_Oryzae]]	[[Albomycin]],
[[Piscicide]]	[[Antimycin_A]],
[[Pivmecillinam]]	[[Nitrofurantoin]],
[[Pl:Warzywa_Kapustne]]	[[Cruciferous_Vegetables]],
[[Placenta]]	[[Trimethoprim]],
[[Plant]]	[[Antibiosis]],[[Phytoalexin]],
[[Plant_Defense_Against_Herbivory]]	[[Phytoalexin]],
[[Plant_Pathology]]	[[Phytoalexin]],
[[Plasmid]]	[[Antibiotic_Resistance]],[[Kanamycin]],[[Hydramacin-1]],[[Methylenomycin_A]],[[Production_Of_Antibiotics]],[[Triclosan]],[[Fosfomycin]],
[[Plasmids]]	[[Antibiotics]],[[Antibiotic_Resistance]],[[Efflux_(microbiology)]],[[Efflux_(microbiology)]],
[[Plasmodium_Falciparum]]	[[Fosmidomycin]],[[(6S)-6-Fluoroshikimic_Acid]],
[[Plasmopara_Viticola]]	[[Phytoalexin]],
[[Plastic]]	[[Bacteriostatic_Agent]],
[[Platelet]]	[[Allistatin]],[[Ristocetin]],
[[Platelet_Aggregation]]	[[Vinyldithiin]],
[[Platelets]]	[[Trimethoprim]],
[[Platensimycin]]	[[Streptomyces_Isolates]],[[List_Of_Antibiotics]],
[[Plazomicin]]	[[Antibiotics]],
[[Plectasin]]	[[Medicinal_Mushroom]],
[[Pleuran]]	[[Medicinal_Mushroom]],
[[Pleuritic]]	[[Nitrofurantoin]],
[[Pleuromutilin]]	[[Medicinal_Mushroom]],
[[Pleurotus_Citrinopileatus]]	[[Medicinal_Mushroom]],
[[Pleurotus_Djamor]]	[[Medicinal_Mushroom]],
[[Pleurotus_Eryngii]]	[[Medicinal_Mushroom]],
[[Pleurotus_Ostreatus]]	[[Medicinal_Mushroom]],[[Medicinal_Mushroom]],
[[Pluramycin_A]]	[[Streptomyces_Isolates]],
[[PlyC]]	[[Antibiotic_Resistance]],
[[Pneumococcus]]	[[Tyrocidine]],
[[Pneumocystis_Jiroveci]]	[[Trimethoprim]],
[[Pneumocystis_Jirovecii]]	[[Dapsone]],
[[Pneumocystis_Pneumonia]]	[[Dapsone]],[[Dapsone]],
[[Pneumonia]]	[[List_Of_Antibiotics]],[[List_Of_Antibiotics]],[[Daptomycin]],[[Antibiotic_Resistance]],
[[Podophyllotoxin]]	[[Medicinal_Molds]],[[Medicinal_Molds]],
[[Poison]]	[[Antimycin_A]],
[[Polybrominated_Biphenyl]]	[[MC21-A]],
[[Polychlorinated_Dibenzodioxins]]	[[Triclosan]],[[Triclosan]],
[[Polychloro_Phenoxy_Phenol]]	[[Triclosan]],
[[Polycyclic_Compound]]	[[Platensimycin]],
[[Polyene]]	[[Endiandric_Acid_C]],[[Hachimycin]],
[[Polyene_Antimycotics]]	[[Streptomyces_Isolates]],
[[Polyether]]	[[Monensin]],
[[Polyethylene_Glycol]]	[[Tyrocidine]],
[[Polyketide]]	[[Zwittermicin_A]],[[Medicinal_Mushroom]],[[Actinorhodin]],[[Nonribosomal_Peptide]],[[Nonribosomal_Peptide]],[[Nonribosomal_Peptide]],[[Salinomycin]],
[[Polyketide_Synthase]]	[[Mupirocin]],[[Geldanamycin]],[[Salinosporamide_A]],[[Naphthomycin_A]],[[Calicheamicin]],[[Salinomycin]],
[[Polymerisation]]	[[Streptazolin]],
[[Polymnia_Fruticosa]]	[[Phytoalexin]],
[[Polymyxin]]	[[Trimethoprim/polymyxin]],
[[Polymyxin_B]]	[[Cell_Envelope_Antibiotic]],[[List_Of_Antibiotics]],
[[Polymyxins]]	[[Antibiotics]],
[[Polyozellin]]	[[Medicinal_Mushroom]],[[Medicinal_Mushroom]],
[[Polyozellus_Multiplex]]	[[Medicinal_Mushroom]],[[Medicinal_Mushroom]],
[[Polypeptide]]	[[Hitachimycin]],
[[Polypeptide_Antibiotics]]	[[List_Of_Antibiotics]],
[[Polypeptides]]	[[Cathelicidin]],
[[Polyphenol]]	[[Topoisomerase_Inhibitor]],[[Phytoalexin]],[[Phytoalexin]],
[[Polyporus_Umbellatus]]	[[Medicinal_Mushroom]],
[[Polysaccharide_Peptide]]	[[Medicinal_Mushroom]],[[Medicinal_Mushroom]],
[[Poria_Cocos]]	[[Medicinal_Mushroom]],
[[Porphyria]]	[[Dapsone]],
[[Posizolid]]	[[List_Of_Antibiotics]],
[[Potassium_Dichromate]]	[[Dapsone]],
[[Potassium_Permanganate]]	[[Bottromycin]],
[[Potency_(pharmacology)]]	[[Novobiocin]],
[[Poudre_River]]	[[Antibiotic_Resistance]],
[[Poultry]]	[[Animal_Drug_Availability_Act_1996]],[[Bambermycin]],
[[Poxviruses]]	[[Ansamycin]],
[[Pravastatin]]	[[Medicinal_Mushroom]],[[Medicinal_Molds]],
[[Prebiotic_(nutrition)]]	[[Medicinal_Mushroom]],
[[Precipitation_(chemistry)]]	[[Production_Of_Antibiotics]],
[[Preclinical]]	[[Arenicin]],
[[Precursor_(chemistry)]]	[[Platensimycin]],[[Cruciferous_Vegetables]],
[[Pregnancy]]	[[Mercer_Protocol]],[[Trimethoprim]],
[[Pregnancy_Category]]	[[4-Aminosalicylic_Acid]],[[Nitrofurantoin]],[[Ethambutol]],
[[Pregnant]]	[[Isoniazid]],
[[Premature_Rupture_Of_Membranes]]	[[Mercer_Protocol]],
[[Prenylated]]	[[Glycyrrhizol]],
[[Prephenate]]	[[Novobiocin]],[[Novobiocin]],
[[Prescription_Drug]]	[[Dapsone]],
[[Prescription_Drug_User_Fee_Act]]	[[Telavancin]],
[[Prescription_Medication]]	[[Tobramycin/dexamethasone]],
[[Preservative]]	[[Bacteriostatic_Agent]],
[[President_Barack_Obama]]	[[Antibiotic_Resistance]],
[[Preventive_Medicine]]	[[Antibiotics]],
[[Primary_Metabolism]]	[[Katanosin]],
[[Primaxin]]	[[List_Of_Antibiotics]],
[[Pristinamycin]]	[[Dalfopristin]],[[Dalfopristin]],[[Pristinamycin_IA]],[[Streptogramin]],
[[Pristinamycin_IA]]	[[Streptogramin_B]],[[Streptogramin_B]],[[Pristinamycin]],
[[Pristinamycin_IIA]]	[[Pristinamycin_IA]],[[Pristinamycin]],[[Streptogramin_B]],
[[Pristinamycine]]	[[Dalfopristin]],
[[Prodrug]]	[[Ethionamide]],[[Isoniazid]],[[Neosalvarsan]],
[[Programmed_Cell_Death]]	[[Beauvericin]],
[[Prokaryotes]]	[[Puromycin]],
[[Prokaryotic]]	[[Kanamycin]],[[Blasticidin_S]],
[[Proline]]	[[Gramicidin_S]],
[[Proline_Motifs]]	[[Cathelicidin]],
[[Prolyl_Endopeptidase]]	[[Medicinal_Mushroom]],[[Medicinal_Mushroom]],
[[Promite]]	[[Medicinal_Mushroom]],
[[Promoter_(genetics)]]	[[Kanamycin]],
[[Prontosil]]	[[Pyocyanase]],[[Antibiotics]],[[Dapsone]],[[List_Of_Antibiotics]],[[List_Of_Antibiotics]],[[The_Demon_Under_The_Microscope]],
[[Propargyl]]	[[Kedarcidin]],
[[Prophylaxis]]	[[Broad-spectrum_Antibiotic]],[[Dapsone]],[[Antibiotics]],
[[Propionate]]	[[Carbomycin]],
[[Propionibacterium_Acnes]]	[[Mupirocin]],[[Fusidic_Acid]],
[[Propionic_Acid]]	[[Nonribosomal_Peptide]],
[[Prostatitis]]	[[Antibiotic_Misuse]],[[Nitrofurantoin]],
[[Prosthetic]]	[[Fusidic_Acid]],
[[Prosthetic_Heart_Valve]]	[[Daptomycin]],
[[Protease]]	[[User:Harmonslide/sandbox]],
[[Proteasome]]	[[Gliotoxin]],
[[Proteasome_Inhibitor]]	[[Salinosporamide_A]],
[[Protecting_Group]]	[[Kedarcidin]],
[[Protein]]	[[Antibiotic_Resistance]],[[Cycloheximide]],[[Efflux_(microbiology)]],[[Katanosin]],[[Daptomycin]],[[Archaeocin]],[[Bacteriostatic_Agent]],[[TAN-1057_C]],[[Hydramacin-1]],[[TAN-1057_A]],[[AGG01]],
[[Protein_Biosynthesis]]	[[Cycloheximide]],[[List_Of_Antibiotics]],
[[Protein_Data_Bank]]	[[Hydramacin-1]],[[Novobiocin]],[[Fusidic_Acid]],[[Hydramacin-1]],[[Geldanamycin]],
[[Protein_Dimer]]	[[Nonribosomal_Peptide]],
[[Protein_Kinase]]	[[Staurosporine]],
[[Protein_Kinase_A]]	[[Pyocyanin]],
[[Protein_Kinase_Inhibitor]]	[[Staurosporine]],
[[Protein_Nuclear_Magnetic_Resonance_Spectroscopy]]	[[Hydramacin-1]],
[[Protein_Synthesis]]	[[Thymineless_Death]],[[Dalfopristin]],[[Carbomycin]],[[Kanamycin]],
[[Protein_Synthesis_Inhibitor]]	[[List_Of_Antibiotics]],[[Nucleic_Acid_Inhibitor]],[[Fusidic_Acid]],[[Puromycin]],[[Template:Antimycobacterials]],
[[Protein_Trimer]]	[[Nonribosomal_Peptide]],
[[Proteinogenic]]	[[Nonribosomal_Peptide]],
[[Proteus_(bacterium)]]	[[Nitrofurantoin]],
[[Proteus_Mirabilis]]	[[Trimethoprim]],
[[Proteus_Vulgaris]]	[[Trimethoprim]],[[AGG01]],
[[Prothionamide]]	[[Template:Antimycobacterials]],
[[Protist]]	[[List_Of_Antibiotics]],
[[Proton]]	[[Multidrug_Tolerance]],[[Efflux_(microbiology)]],
[[Protozoa]]	[[Furazolidone]],[[Reuterin]],[[Multidrug_Tolerance]],
[[Protozoal]]	[[List_Of_Antibiotics]],
[[Protozoan_Infection]]	[[Antibiotics]],
[[Providencia_(bacterium)]]	[[Trimethoprim]],
[[Pruritus]]	[[Nitrofurantoin]],[[Spectinomycin]],[[Daptomycin]],
[[Pseudoalteromonas_Phenolica]]	[[MC21-B]],[[MC21-A]],
[[Pseudomembranous_Colitis]]	[[Trimethoprim]],
[[Pseudomembranous_Enterocolitis]]	[[List_Of_Antibiotics]],
[[Pseudomonas]]	[[DB-2073]],[[List_Of_Antibiotics]],[[Extended-spectrum_Penicillin]],[[Antibiotic_Resistance]],[[Nitrofurantoin]],[[AGG01]],
[[Pseudomonas_Aeruginosa]]	[[Antibiotic_Resistance]],[[Trimethoprim]],[[Pyocyanin]],[[Pyocyanase]],[[Antibiotic_Resistance]],[[Triclosan]],[[Pyocyanin]],[[List_Of_Antibiotics]],
[[Pseudomonas_Fluorescens]]	[[Mupirocin]],
[[Pseudomonas_Palida]]	[[Endiandric_Acid_C]],
[[Pseudoplectania_Nigrella]]	[[Plectasin]],
[[Psilocin]]	[[Medicinal_Mushroom]],
[[Psychosis]]	[[Dapsone]],[[Antibiotic_Misuse]],[[Cycloserine]],
[[Psychotropic]]	[[Cycloserine]],
[[Pterocarpan]]	[[Glycyrrhizol]],
[[Pterostilbene]]	[[Phytoalexin]],
[[Pterulone]]	[[Medicinal_Mushroom]],
[[Public_Health]]	[[Animal_Drug_Availability_Act_1996]],
[[Pulmonary_Disease]]	[[Dapsone]],
[[Pulmonary_Edema]]	[[Nitrofurantoin]],
[[Pulmonary_Fibrosis]]	[[Nitrofurantoin]],
[[Pulmonary_Surfactant]]	[[Daptomycin]],
[[Pulvinic_Acid]]	[[Pulvinone]],[[Pulvinone]],[[Pulvinone]],[[Pulvinone]],
[[Puromycin]]	[[Streptomyces_Isolates]],
[[Pyelonephritis]]	[[Nitrofurantoin]],
[[Pyocyanin]]	[[Pyocyanase]],
[[Pyostomatitis_Vegetans]]	[[Dapsone]],
[[Pyran]]	[[Mupirocin]],
[[Pyrazinamide]]	[[Template:Antimycobacterials]],[[List_Of_Antibiotics]],[[Ethambutol]],[[4-Aminosalicylic_Acid]],[[4-Aminosalicylic_Acid]],
[[Pyrazine]]	[[Template:Antimycobacterials]],
[[Pyridine]]	[[Aspergillic_Acid]],[[Solithromycin]],
[[Pyridoxine]]	[[Cycloserine]],[[Isoniazid]],[[Isoniazid]],
[[Pyrimethamine]]	[[Dapsone]],
[[Pyrimidine]]	[[Thymineless_Death]],
[[Pyrone]]	[[Myxopyronin]],
[[Pyrroline]]	[[Dalfopristin]],
[[Pyruvate]]	[[Nitrofurantoin]],
[[Pyruvic_Acid]]	[[Platensimycin]],
[[QT_Interval]]	[[List_Of_Antibiotics]],
[[Quercetin]]	[[Topoisomerase_Inhibitor]],
[[Quercinol]]	[[Medicinal_Mushroom]],[[Medicinal_Mushroom]],[[Medicinal_Mushroom]],[[Medicinal_Mushroom]],
[[Quinolone]]	[[Aminocoumarin]],[[Antibiotics]],[[Antibiotics]],[[Antibiotic_Resistance]],[[Nitrofurantoin]],[[List_Of_Antibiotics]],[[Topoisomerase_Inhibitor]],[[NXL103]],
[[Quinolones]]	[[SmeT]],[[Antibiotic_Resistance]],[[Antibiotic_Resistance]],[[Antibiotics]],[[Nucleic_Acid_Inhibitor]],[[Antibiotic_Resistance]],
[[Quintessence_International]]	[[Antibiotic_Misuse]],
[[Quinupristin]]	[[Dalfopristin]],[[Dalfopristin]],[[Streptogramin_B]],
[[Quorn]]	[[Medicinal_Mushroom]],
[[Quorum_Sensing]]	[[Pyocyanin]],
[[RDX]]	[[Hexamethylenetetramine]],[[Hexamethylenetetramine]],
[[RNA]]	[[List_Of_Antibiotics]],[[Nucleic_Acid_Inhibitor]],[[Leptomycin]],[[Raphanin]],[[List_Of_Antibiotics]],[[Daptomycin]],[[Streptolydigin]],
[[RNA_Polymerase]]	[[Myxopyronin]],[[List_Of_Antibiotics]],[[Antibiotic_Resistance]],[[Streptolydigin]],[[Template:Antimycobacterials]],
[[RNA_Polymerase_III]]	[[Streptolydigin]],
[[RNA_Transcription]]	[[Thymineless_Death]],
[[Racemate]]	[[Allicin]],
[[Racemic]]	[[Allicin]],[[Streptazolin]],
[[Racemic_Mixture]]	[[Platensimycin]],
[[Racemization]]	[[Aspergillic_Acid]],
[[Radezolid]]	[[List_Of_Antibiotics]],
[[Radical_(chemistry)]]	[[Allicin]],[[Enediyne]],
[[Radical_SAM]]	[[Kedarcidin]],
[[Radicicol]]	[[Medicinal_Molds]],
[[Radionuclides]]	[[Medicinal_Mushroom]],
[[Radish]]	[[Cruciferous_Vegetables]],[[Raphanin]],[[Allyl_Isothiocyanate]],[[Allicin]],
[[Rainforest]]	[[Endiandric_Acid_C]],
[[Ramoplanin]]	[[Mupirocin]],
[[Ranbaxy]]	[[Fusidic_Acid]],
[[Random_Mutation]]	[[Antibiotic_Resistance]],
[[Randomized_Clinical_Trial]]	[[Allicin]],
[[Randomized_Controlled_Trial]]	[[Triclosan]],
[[Rapeseed]]	[[Cruciferous_Vegetables]],
[[Raphanus_Sativus]]	[[Raphanin]],
[[Rapini]]	[[Cruciferous_Vegetables]],
[[Rash]]	[[Dapsone]],[[Dapsone]],[[Isoniazid]],
[[Rational_Drug_Design]]	[[Production_Of_Antibiotics]],
[[Raxar]]	[[List_Of_Antibiotics]],
[[Reactive_Oxygen_Intermediate]]	[[Pyocyanin]],
[[Reactive_Oxygen_Species]]	[[Phytoalexin]],[[Pyocyanin]],
[[Reagent]]	[[Hexamethylenetetramine]],
[[Rebeccamycin]]	[[Streptomyces_Isolates]],[[Staurosporine]],
[[Recall_Bias]]	[[Nitrofurantoin]],
[[Receptor_(biochemistry)]]	[[Efflux_(microbiology)]],
[[Receptor_Antagonist]]	[[Kendomycin]],
[[Red_Blood_Cells]]	[[Nitrofurantoin]],[[Surfactin]],
[[Red_Cabbage]]	[[Raphanin]],
[[Red_Yeast_Rice]]	[[Medicinal_Molds]],[[Medicinal_Molds]],
[[Redox]]	[[Nonribosomal_Peptide]],
[[Reduction_(chemistry)]]	[[Streptazolin]],
[[Refractive_Index]]	[[Dalfopristin]],
[[Regioselectivity]]	[[Kedarcidin]],
[[Regul_Toxicol_Pharmacol]]	[[Antibiotic_Resistance]],
[[Relapse]]	[[Multidrug_Tolerance]],
[[Renal_Failure]]	[[Isoniazid]],[[Daptomycin]],[[List_Of_Antibiotics]],
[[Rene_Dubos]]	[[Antibiotics]],
[[Reproduction]]	[[Production_Of_Antibiotics]],[[Cycloheximide]],
[[Republican_Party_(United_States)]]	[[Animal_Drug_Availability_Act_1996]],
[[Research_And_Development]]	[[Antibiotic_Resistance]],
[[Residue_(chemistry)]]	[[Platensimycin]],
[[Resin]]	[[Hexamethylenetetramine]],
[[Resistome]]	[[Antibiotic_Resistance]],
[[Respiratory_Burst]]	[[Dapsone]],
[[Respiratory_Illness]]	[[Antibiotic_Misuse]],
[[Respiratory_Tract]]	[[Clofoctol]],
[[Respiratory_Tract_Infection]]	[[Antibiotics]],
[[Respiratory_Tract_Infections]]	[[Solithromycin]],
[[Resveratrol]]	[[Phytoalexin]],[[Medicinal_Molds]],[[Topoisomerase_Inhibitor]],
[[Retapamulin]]	[[Medicinal_Mushroom]],
[[Retrospective_Study]]	[[Nitrofurantoin]],
[[Retrosynthetic_Analysis]]	[[Kedarcidin]],
[[Rhabdomyolysis]]	[[Fusidic_Acid]],[[Daptomycin]],[[Fusidic_Acid]],
[[Rhamnose]]	[[Actaplanin]],
[[Rheumatism]]	[[Endiandric_Acid_C]],
[[Rheumatoid_Arthritis]]	[[Clofazimine]],
[[Rhizopus_Oligosporus]]	[[Medicinal_Molds]],
[[Ribonucleoprotein]]	[[Leptomycin]],
[[Ribosome]]	[[Nitrofurantoin]],[[Carbomycin]],[[Fusidic_Acid]],[[Blasticidin_S]],[[Bottromycin]],[[Puromycin]],[[Puromycin]],[[List_Of_Antibiotics]],[[Dalfopristin]],[[List_Of_Antibiotics]],[[Nonribosomal_Peptide]],[[Nonribosomal_Peptide]],[[Spectinomycin]],[[User:Harmonslide/sandbox]],
[[Ribosomes]]	[[Kanamycin]],[[Antibiotic_Resistance]],
[[Rice]]	[[Phytoalexin]],
[[Richard_Gallo]]	[[Cathelicidin]],
[[Richard_Synge]]	[[Gramicidin_S]],
[[Rickettsia]]	[[List_Of_Antibiotics]],
[[Rifabutin]]	[[Template:Antimycobacterials]],[[List_Of_Antibiotics]],
[[Rifampicin]]	[[4-Aminosalicylic_Acid]],[[Pristinamycin]],[[Dapsone]],[[Fusidic_Acid]],[[Thioacetazone]],[[Antibiotics]],[[Ethambutol]],[[Template:Antimycobacterials]],[[4-Aminosalicylic_Acid]],[[4-Aminosalicylic_Acid]],[[Clofazimine]],[[Promin]],[[List_Of_Antibiotics]],[[4-Aminosalicylic_Acid]],
[[Rifampin]]	[[Isoniazid]],[[Antibiotic_Resistance]],[[Nucleic_Acid_Inhibitor]],[[Antibiotic_Resistance]],
[[Rifamycin]]	[[Myxopyronin]],[[Template:Antimycobacterials]],[[Ansamycin]],[[Antibiotics]],
[[Rifamycins]]	[[Ansamycin]],
[[Rifapentine]]	[[Template:Antimycobacterials]],[[List_Of_Antibiotics]],
[[Rifaximin]]	[[List_Of_Antibiotics]],
[[Ro:Legume_Crucifere]]	[[Cruciferous_Vegetables]],
[[Robert_Burns_Woodward]]	[[Carbomycin]],
[[Robert_Koch]]	[[Antibiotics]],
[[Roberts_Laboratories]]	[[Furazolidone]],
[[Rocephin]]	[[List_Of_Antibiotics]],
[[Romanesco_Broccoli]]	[[Cruciferous_Vegetables]],
[[Rosacea]]	[[Cathelicidin]],
[[Rosetrees_Trust]]	[[Seraticin]],
[[Rotenone]]	[[Efflux_(microbiology)]],
[[Roxithromycin]]	[[List_Of_Antibiotics]],
[[Rubella]]	[[Endiandric_Acid_C]],
[[Rubratoxin_B]]	[[Medicinal_Molds]],
[[Rudolph_Emmerich]]	[[Pyocyanase]],
[[Rutabaga]]	[[Cruciferous_Vegetables]],
[[Rutgers_University]]	[[Albert_Schatz_(scientist)]],[[Albert_Schatz_(scientist)]],[[Albert_Schatz_(scientist)]],
[[Ruthenium_Dioxide]]	[[Dalfopristin]],
[[SQ109]]	[[Template:Antimycobacterials]],
[[S_Phase]]	[[Aphidicolin]],
[[Saccharomyces_Boulardii]]	[[Medicinal_Molds]],[[Medicinal_Mushroom]],
[[Saccharomyces_Cerevisiae]]	[[Thiolutin]],[[Medicinal_Mushroom]],[[Medicinal_Molds]],
[[Saccharopolyspora_Erythraea]]	[[Streptomyces_Isolates]],
[[Sahachiro_Hata]]	[[Arsphenamine]],
[[Sakuranetin]]	[[Efflux_(microbiology)]],[[Phytoalexin]],
[[Salicylic_Acid]]	[[Phytoalexin]],[[4-Aminosalicylic_Acid]],
[[Salinispora_Arenicola]]	[[Salinosporamide_A]],
[[Salinispora_Tropica]]	[[Salinosporamide_A]],
[[Salinomycin]]	[[Narasin]],
[[Salinosporamide]]	[[Salinosporamide_A]],
[[Salinosporamide_B]]	[[Salinosporamide_A]],
[[Salmon]]	[[Furazolidone]],
[[Salmonella]]	[[AGG01]],[[Trimethoprim]],[[Subtherapeutic_Antibiotic_Use_In_Swine]],[[Antibiotics]],[[Animal_Drug_Availability_Act_1996]],[[Antibiotic_Resistance]],[[Furazolidone]],[[Nifuroxazide]],
[[Salmonella_Dublin]]	[[Furazolidone]],
[[Salmonella_Typhi]]	[[Raphanin]],
[[Salmonella_Typhimurium]]	[[Furazolidone]],
[[Salt]]	[[Aspergillic_Acid]],
[[Salt_(chemistry)]]	[[Fusidic_Acid]],
[[Salvarsan]]	[[List_Of_Antibiotics]],[[Antibiotics]],[[Neosalvarsan]],
[[Salvestrols]]	[[Phytoalexin]],
[[Saponification]]	[[Pulvinone]],
[[Saprotroph]]	[[Daptomycin]],
[[Scabronine]]	[[Medicinal_Mushroom]],
[[Scanning_Electron_Micrograph]]	[[Antibiotics]],
[[Schizophyllan]]	[[Medicinal_Mushroom]],
[[Schizophyllum_Commune]]	[[Medicinal_Mushroom]],
[[Schizosaccharomyces_Pombe]]	[[Leptomycin]],[[Leptomycin]],
[[Science_And_Development_Network]]	[[Antibiotic_Resistance]],
[[Science_Education]]	[[Albert_Schatz_(scientist)]],
[[Sclerotiorin]]	[[Medicinal_Molds]],
[[Sclerotium]]	[[Medicinal_Mushroom]],
[[Sclerotium_Rolfsii]]	[[Medicinal_Mushroom]],
[[Scorpion]]	[[Hydramacin-1]],
[[Scorpion_Oxin]]	[[Hydramacin-1]],
[[Scripps_Research_Institute]]	[[Kedarcidin]],
[[Sea_Anemone]]	[[Hydramacin-1]],
[[Secondary_Metabolism]]	[[Katanosin]],
[[Secondary_Metabolite]]	[[Peptaibol]],[[Bottromycin]],[[Production_Of_Antibiotics]],
[[Secondary_Metabolites]]	[[Nonribosomal_Peptide]],
[[Secondary_Neoplasm]]	[[Topoisomerase_Inhibitor]],
[[Secondary_Transporters]]	[[Efflux_(microbiology)]],
[[Seizure]]	[[Isoniazid]],
[[Seizures]]	[[Cycloserine]],
[[Selectable_Marker]]	[[Antibiotic_Resistance]],
[[Selective_Breeding]]	[[Cruciferous_Vegetables]],
[[Selective_Pressure]]	[[Antibiotic_Resistance]],
[[Selective_Toxicity]]	[[Dapsone]],
[[Selman_Waksman]]	[[Albert_Schatz_(scientist)]],[[Antibiotics]],[[Antibiotic_Resistance]],[[Antibiotics]],[[Albert_Schatz_(scientist)]],
[[Semipermeable_Membrane]]	[[Antibiotic_Resistance]],
[[Semisynthetic]]	[[Antibiotics]],
[[Sensors_And_Actuators_B:_Chemical]]	[[Monensin]],
[[Sepsis]]	[[Antibiotic_Resistance]],[[Antibiotic_Resistance]],[[Carbomycin]],
[[Sequenced]]	[[Aminocoumarin]],
[[Serbia]]	[[Fusidic_Acid]],
[[Serine]]	[[Cycloserine]],[[Nucleic_Acid_Inhibitor]],[[Nonribosomal_Peptide]],[[Nonribosomal_Peptide]],[[Nonribosomal_Peptide]],[[User:Harmonslide/sandbox]],
[[Serine_Palmitoyltransferase]]	[[Myriocin]],
[[Serine_Protease]]	[[Puromycin]],
[[Serotonin_Receptor_Agonist]]	[[Medicinal_Mushroom]],
[[Serratia]]	[[Trimethoprim]],
[[Serum_(blood)]]	[[Raphanin]],
[[Sexually_Transmitted_Disease]]	[[Gramicidin_S]],
[[Shampoo]]	[[Triclosan]],
[[Shampoos]]	[[Avenanthramide]],
[[Sheffield_University]]	[[Albert_Schatz_(scientist)]],
[[Shiga_Toxin]]	[[Trimethoprim]],
[[Shigella]]	[[Antibiotics]],[[Trimethoprim]],
[[Shigella_Dysenteriae]]	[[Raphanin]],
[[Shikimate_Pathway]]	[[(6S)-6-Fluoroshikimic_Acid]],
[[Shikimic_Acid]]	[[Endiandric_Acid_C]],[[(6S)-6-Fluoroshikimic_Acid]],[[Pyocyanin]],[[Novobiocin]],
[[Shuttle_Vector]]	[[Kanamycin]],
[[Siberian_Kale]]	[[Cruciferous_Vegetables]],
[[Side_Effect]]	[[Solithromycin]],[[Tobramycin/dexamethasone]],
[[Side_Effects]]	[[Antibiotics]],
[[Sideroblastic_Anemia]]	[[Isoniazid]],[[Isoniazid]],
[[Sideromycin]]	[[Albomycin]],
[[Siderophore]]	[[Nonribosomal_Peptide]],[[Nonribosomal_Peptide]],[[Novobiocin]],
[[Silver_Sulfadiazine]]	[[List_Of_Antibiotics]],[[Mupirocin]],
[[Simple_Aromatic_Ring]]	[[Triclosan]],[[Triclosan]],
[[Simvastatin]]	[[Medicinal_Mushroom]],[[Medicinal_Molds]],
[[Sinigrin]]	[[Cruciferous_Vegetables]],[[Allyl_Isothiocyanate]],
[[Sinusitis]]	[[Antibiotic_Resistance]],[[Antibiotic_Misuse]],
[[Sirolimus]]	[[Streptomyces_Isolates]],[[Streptomyces_Isolates]],
[[Sirtuin]]	[[Trichostatin_A]],
[[Skeletal_Formula]]	[[Aminocoumarin]],
[[Skin_And_Skin_Structure_Infection]]	[[NXL103]],[[Daptomycin]],[[Taksta]],
[[Sludge]]	[[Triclosan]],
[[Small_Molecule]]	[[Antibiotics]],
[[Soap]]	[[Surfactin]],
[[Social_Anxiety_Disorder]]	[[Cycloserine]],
[[Sodium]]	[[Efflux_(microbiology)]],[[Fusidic_Acid]],
[[Sodium_Acetate]]	[[Carbomycin]],
[[Sodium_Aminosalicylate]]	[[Template:Antimycobacterials]],
[[Sodium_Azide]]	[[Bacteriostatic_Agent]],
[[Sodium_Borohydride]]	[[Kedarcidin]],
[[Sodium_Cyanide]]	[[Endiandric_Acid_C]],
[[Sodium_Hydroxide]]	[[Triclosan]],
[[Sodium_Periodate]]	[[Dalfopristin]],
[[Sodium_Tartrate]]	[[Carbomycin]],
[[Sodium_Tungstate]]	[[Dalfopristin]],
[[Soil_Sample]]	[[Platensimycin]],
[[Solid]]	[[Pulvinone]],[[Triclosan]],
[[Solid_Phase_Peptide_Synthesis]]	[[Tyrocidine]],
[[Solubility]]	[[Dalfopristin]],
[[Soluble]]	[[Production_Of_Antibiotics]],
[[Solution]]	[[Surfactin]],[[Triclosan]],
[[Solvent_Extraction]]	[[Vinyldithiin]],
[[Sommelet_Reaction]]	[[Hexamethylenetetramine]],
[[Sonogashira_Coupling]]	[[Kedarcidin]],
[[Sorghum]]	[[Phytoalexin]],
[[Southeast_Asia]]	[[Medicinal_Mushroom]],
[[Soviet_Union]]	[[Antibiotic_Resistance]],
[[Sparassis_Crispa]]	[[Sparassol]],[[Medicinal_Mushroom]],
[[Sparassol]]	[[Medicinal_Mushroom]],
[[Sparfloxacin]]	[[List_Of_Antibiotics]],
[[Species]]	[[Cruciferous_Vegetables]],
[[Specificity_(tests)]]	[[Nonribosomal_Peptide]],
[[Spectinomycin]]	[[List_Of_Antibiotics]],[[Bacteriostatic_Agent]],
[[Spectracef]]	[[List_Of_Antibiotics]],
[[Spermatozoon]]	[[Cycloheximide]],
[[Spheroplasts]]	[[Fosfomycin]],
[[Sphingolipid]]	[[Myriocin]],
[[Sphingomyelin_Phosphodiesterase]]	[[Clofazimine]],
[[Sphingosine]]	[[Myriocin]],
[[Spiramycin]]	[[List_Of_Antibiotics]],
[[Spirochaete]]	[[List_Of_Antibiotics]],
[[Spirochete]]	[[Arsphenamine]],
[[Spleen]]	[[Clofazimine]],
[[Sponge_Isolates]]	[[Streptomyces_Isolates]],
[[Sporolides]]	[[Kedarcidin]],
[[Sporulation]]	[[Tyrocidine]],
[[Staining]]	[[Hexamethylenetetramine]],
[[Stalin_Prize]]	[[Gramicidin_S]],
[[Staphylococcal]]	[[Dalfopristin]],[[Carbomycin]],
[[Staphylococcal_Infection]]	[[Ristocetin]],
[[Staphylococci]]	[[Katanosin]],
[[Staphylococcus]]	[[Daptomycin]],[[Dalfopristin]],[[Plectasin]],[[Furazolidone]],[[Novobiocin]],[[Fusidic_Acid]],[[Dalfopristin]],[[Furazolidone]],[[Pristinamycin]],[[Nifuroxazide]],[[Allistatin]],
[[Staphylococcus_Aureus]]	[[Fusidic_Acid]],[[Telavancin]],[[Antibiotic_Resistance]],[[Antibiotic_Resistance]],[[TAN-1057_C]],[[Enzybiotics]],[[GSK_299423]],[[Nitrofurantoin]],[[Bottromycin]],[[Triclosan]],[[TAN-1057_A]],[[Trimethoprim]],[[Antibiotic_Resistance]],[[AGG01]],[[Mupirocin]],[[Antibiotic_Resistance]],[[Antibiotics]],[[Daptomycin]],
[[Staphylococcus_Epidermidis]]	[[Novobiocin]],
[[Staphylococcus_Saprophyticus]]	[[Novobiocin]],[[Trimethoprim]],
[[Staphylococus]]	[[Raphanin]],[[Raphanin]],
[[State_Of_Matter]]	[[Dalfopristin]],
[[Statin]]	[[Daptomycin]],[[Medicinal_Molds]],[[Medicinal_Molds]],
[[Statins]]	[[Fusidic_Acid]],[[Medicinal_Mushroom]],
[[Status_Epilepticus]]	[[Isoniazid]],
[[Stauprimide]]	[[Streptomyces_Isolates]],[[Staurosporine]],
[[Staurosporine]]	[[Streptomyces_Isolates]],
[[Steclin]]	[[List_Of_Antibiotics]],
[[Stem_Cell]]	[[Salinomycin]],
[[Stenotrophomonas_Maltophilia]]	[[Trimethoprim]],[[SmeT]],
[[Stereoisomer]]	[[Gramicidin_S]],
[[Steroid]]	[[Thiostrepton]],[[Phytoalexin]],[[Thiostrepton]],
[[Sterol]]	[[Ceragenin]],
[[Stilbenoid]]	[[Phytoalexin]],[[Phytoalexin]],
[[Stochastic]]	[[Multidrug_Tolerance]],
[[Stochastic_Process]]	[[Subtherapeutic_Antibiotic_Use_In_Swine]],
[[Stomatitis]]	[[Daptomycin]],
[[Strain_(biology)]]	[[Antibiotic_Resistance]],
[[Strains_(biology)]]	[[Platensimycin]],
[[Streptococcal_Infection]]	[[List_Of_Antibiotics]],[[List_Of_Antibiotics]],
[[Streptococci]]	[[AGG01]],
[[Streptococcus]]	[[Ambazone]],[[Furazolidone]],[[Pristinamycin]],[[Daptomycin]],[[Plectasin]],[[Fusidic_Acid]],[[Trimethoprim]],
[[Streptococcus_Agalactiae]]	[[Nitrofurantoin]],
[[Streptococcus_Faecalis]]	[[Endiandric_Acid_C]],
[[Streptococcus_Mutans]]	[[Glycyrrhizol]],
[[Streptococcus_Pneumoniae]]	[[Raphanin]],[[Trimethoprim]],[[Antibiotic_Resistance]],[[Albomycin]],[[Ambazone]],
[[Streptococcus_Pyogenes]]	[[Antibiotic_Resistance]],
[[Streptococcus_Viridans]]	[[Trimethoprim]],[[Ambazone]],
[[Streptococus]]	[[Raphanin]],
[[Streptogramin]]	[[Streptogramin_B]],[[Pristinamycin]],[[Dalfopristin]],[[NXL103]],
[[Streptogramin_A]]	[[Streptogramin]],[[Dalfopristin]],
[[Streptogramin_B]]	[[Streptogramin]],[[Linopristin]],[[Pristinamycin_IA]],
[[Streptogramins]]	[[Dalfopristin]],
[[Streptomyces]]	[[Kendomycin]],[[Streptomyces_Isolates]],[[Thiostrepton]],[[Kettapeptin]],[[Leptomycin]],[[Fosfomycin]],[[Hitachimycin]],[[Fosfomycin]],[[Pristinamycin]],[[Aminocoumarin]],[[Chromomycin_A3]],[[Thiolutin]],[[Vulgamycin]],[[Roseophilin]],[[Fosfomycin]],[[Aminocoumarin]],[[A23187]],[[Streptogramin_B]],[[Lasalocid]],[[Fosmidomycin]],[[Staurosporine]],[[Bottromycin]],[[Antimycin_A]],[[Monensin]],[[Tunicamycin]],[[Caprazamycin]],[[Platensimycin]],[[Bottromycin]],[[Naphthomycin_A]],[[Streptazolin]],
[[Streptomyces_Alboniger]]	[[Puromycin]],[[Streptomyces_Isolates]],
[[Streptomyces_Aureofaciens]]	[[Streptomyces_Isolates]],
[[Streptomyces_Avermitilis]]	[[Streptomyces_Isolates]],[[Streptomyces_Isolates]],
[[Streptomyces_Azureus]]	[[Thiostrepton]],
[[Streptomyces_Bambergiensis]]	[[Bambermycin]],
[[Streptomyces_Chartreusensis]]	[[A23187]],
[[Streptomyces_Clavuligerus]]	[[Streptomyces_Isolates]],
[[Streptomyces_Coelicolor]]	[[Methylenomycin_B]],[[Streptomyces_Isolates]],[[Methylenomycin_A]],[[Streptomyces_Isolates]],[[Actinorhodin]],[[Aminocoumarin]],
[[Streptomyces_Fradiae]]	[[Fosfomycin]],[[Streptomyces_Isolates]],[[Streptomyces_Isolates]],
[[Streptomyces_Griseoplanus]]	[[Alazopeptin]],
[[Streptomyces_Griseus]]	[[Streptomyces_Isolates]],[[Bafilomycin]],[[Streptomyces_Isolates]],[[Cycloheximide]],
[[Streptomyces_Halstedii]]	[[Carbomycin]],
[[Streptomyces_Hygroscopicus]]	[[Nigericin]],[[Geldanamycin]],[[Streptomyces_Isolates]],[[Validamycin]],
[[Streptomyces_Isolates]]	[[Medicinal_Mushroom]],[[Medicinal_Molds]],
[[Streptomyces_Kanamyceticus]]	[[Kanamycin]],
[[Streptomyces_Laurentii]]	[[Thiostrepton]],
[[Streptomyces_Lincolnensis]]	[[Streptomyces_Isolates]],
[[Streptomyces_Natalensis]]	[[Streptomyces_Isolates]],
[[Streptomyces_Niveus]]	[[Novobiocin]],
[[Streptomyces_Nodosus]]	[[Streptomyces_Isolates]],
[[Streptomyces_Noursei]]	[[Streptomyces_Isolates]],
[[Streptomyces_Peucetius]]	[[Streptomyces_Isolates]],
[[Streptomyces_Pristinaespiralis]]	[[Efflux_(microbiology)]],
[[Streptomyces_Rimosus]]	[[Streptomyces_Isolates]],
[[Streptomyces_Roseosporus]]	[[Daptomycin]],[[Streptomyces_Isolates]],
[[Streptomyces_Spectabilis]]	[[Spectinomycin]],
[[Streptomyces_Venezuelae]]	[[Streptomyces_Isolates]],
[[Streptomyces_Viridochromeogenes]]	[[Streptomyces_Isolates]],
[[Streptomycete]]	[[Aplasmomycin]],
[[Streptomycin]]	[[Antibiotic_Resistance]],[[4-Aminosalicylic_Acid]],[[Bottromycin]],[[List_Of_Antibiotics]],[[List_Of_Antibiotics]],[[Streptomyces_Isolates]],[[Albert_Schatz_(scientist)]],[[Isoniazid]],[[Streptomyces_Isolates]],[[Template:Antimycobacterials]],[[Antibiotic_Resistance]],[[Broad-spectrum_Antibiotic]],[[4-Aminosalicylic_Acid]],[[Broad-spectrum_Antibiotic]],[[Albert_Schatz_(scientist)]],[[4-Aminosalicylic_Acid]],[[Albert_Schatz_(scientist)]],
[[Streptovaricins]]	[[Ansamycin]],
[[Stress_(mechanics)]]	[[Phytoalexin]],
[[Strobilurin]]	[[Medicinal_Mushroom]],[[Medicinal_Mushroom]],[[Medicinal_Molds]],
[[Stye]]	[[Tobramycin/dexamethasone]],
[[Styela_Clava]]	[[Styelin_A]],
[[Sublimation_(chemistry)]]	[[Hexamethylenetetramine]],[[Hexamethylenetetramine]],
[[Substance_P]]	[[Avenanthramide]],
[[Substrate_(biochemistry)]]	[[Efflux_(microbiology)]],[[Nonribosomal_Peptide]],
[[Subtropical]]	[[Endiandric_Acid_C]],
[[Subway_Restaurant]]	[[Animal_Drug_Availability_Act_1996]],
[[Suicide]]	[[Clofazimine]],
[[Suillus]]	[[Pulvinone]],
[[Suillus_Grevillei]]	[[Pulvinone]],[[Pulvinone]],
[[Sulbactam]]	[[Antibiotics]],
[[Sulfa_Drug]]	[[Dapsone]],
[[Sulfa_Drugs]]	[[Antibiotic_Resistance]],
[[Sulfacetamide]]	[[List_Of_Antibiotics]],
[[Sulfadiazine]]	[[List_Of_Antibiotics]],
[[Sulfadimethoxine]]	[[List_Of_Antibiotics]],
[[Sulfafurazole]]	[[Erythromycin/sulfafurazole]],
[[Sulfamethizole]]	[[List_Of_Antibiotics]],
[[Sulfamethoxazole]]	[[List_Of_Antibiotics]],[[Dapsone]],[[Trimethoprim]],[[Trimethoprim]],[[Thymineless_Death]],[[Trimethoprim]],[[List_Of_Antibiotics]],
[[Sulfanilamide]]	[[Dapsone]],[[The_Demon_Under_The_Microscope]],
[[Sulfanilimide]]	[[List_Of_Antibiotics]],
[[Sulfasalazine]]	[[List_Of_Antibiotics]],[[4-Aminosalicylic_Acid]],
[[Sulfate]]	[[Kanamycin]],[[Dalfopristin]],
[[Sulfisoxazole]]	[[List_Of_Antibiotics]],
[[Sulfolobus]]	[[Archaeocin]],
[[Sulfonamide_(medicine)]]	[[Broad-spectrum_Antibiotic]],[[Erythromycin/sulfafurazole]],[[The_Demon_Under_The_Microscope]],[[Trimethoprim]],[[Antibiotics]],[[List_Of_Antibiotics]],[[Antibiotics]],[[Bacteriostatic_Agent]],[[Antibiotics]],[[Antibiotics]],[[Antibiotic_Resistance]],
[[Sulfone]]	[[Promin]],[[Dalfopristin]],[[Dapsone]],
[[Sulforaphane]]	[[Raphanin]],
[[Sulfoxone]]	[[Promin]],
[[Sulfur]]	[[Nonribosomal_Peptide]],
[[Sulfuric_Acid]]	[[Hexamethylenetetramine]],[[Dapsone]],
[[Sumamed]]	[[List_Of_Antibiotics]],
[[Sumycin]]	[[List_Of_Antibiotics]],
[[Sunday_Herald]]	[[Triclosan]],
[[Superfamily_(molecular_Biology)]]	[[Hydramacin-1]],
[[Superinfection]]	[[Broad-spectrum_Antibiotic]],
[[Superoxide]]	[[Phytoalexin]],[[Pyocyanin]],[[Antimycin_A]],
[[Superoxide_Dismutase]]	[[Pyocyanin]],
[[Suppository]]	[[Clofoctol]],
[[Supraventricular_Tachycardia]]	[[Daptomycin]],
[[Suprax]]	[[List_Of_Antibiotics]],
[[Surface_Tension]]	[[Surfactin]],
[[Surfactant]]	[[Surfactin]],[[Daptomycin]],
[[Surfactin]]	[[Lipopeptide]],
[[Surfactin_Synthetase]]	[[Surfactin]],
[[Surgical_Wound]]	[[Antibiotics]],
[[Swansea_University]]	[[Seraticin]],
[[Swine]]	[[Subtherapeutic_Antibiotic_Use_In_Swine]],[[Animal_Drug_Availability_Act_1996]],
[[Symbiosis]]	[[Antibiosis]],
[[Symporter]]	[[Efflux_(microbiology)]],
[[Synapse]]	[[Bafilomycin]],
[[Synercid]]	[[Streptogramin_B]],[[Pristinamycin]],[[List_Of_Antibiotics]],[[Quinupristin]],[[Dalfopristin]],
[[Synergistic]]	[[Trimethoprim]],
[[Synergy]]	[[Fusidic_Acid]],
[[Synthase]]	[[Zwittermicin_A]],
[[Synthetase]]	[[Surfactin]],
[[Synthetic]]	[[Arylomycin_A2]],
[[Syphilis]]	[[List_Of_Antibiotics]],[[List_Of_Antibiotics]],[[Neosalvarsan]],[[Arsphenamine]],[[List_Of_Antibiotics]],
[[Systematic_Review]]	[[Triclosan]],
[[Systemic_Infection]]	[[Antibiotics]],
[[TCA_Cycle]]	[[Platensimycin]],
[[THF]]	[[Endiandric_Acid_C]],
[[TLR_1]]	[[Lipopeptide]],
[[TMEDA]]	[[Ethambutol]],
[[TRNA]]	[[Carbomycin]],[[Puromycin]],[[Puromycin]],
[[TRPA1]]	[[Allyl_Isothiocyanate]],
[[TRPV1]]	[[Allyl_Isothiocyanate]],
[[T_Cell]]	[[Myriocin]],
[[T_Cells]]	[[Clofazimine]],
[[Tablet_(pharmacy)]]	[[Fusidic_Acid]],
[[Tacrolimus]]	[[Streptomyces_Isolates]],
[[Taiwanofungus_Camphoratus]]	[[Medicinal_Mushroom]],
[[Taksta]]	[[Fusidic_Acid]],[[Fusidic_Acid]],
[[Tammar_Wallaby]]	[[AGG01]],
[[Tang_Dynasty]]	[[Medicinal_Mushroom]],
[[Targeted_Therapy]]	[[Salinomycin]],[[Calicheamicin]],
[[Tatsoi]]	[[Cruciferous_Vegetables]],
[[Tautomeric]]	[[Aspergillic_Acid]],
[[Tautomerize]]	[[Endiandric_Acid_C]],
[[Taxonomy_(biology)]]	[[Cruciferous_Vegetables]],
[[Taxus]]	[[Medicinal_Molds]],
[[Tazobactam]]	[[Antibiotics]],
[[Tea]]	[[Topoisomerase_Inhibitor]],
[[Teflaro]]	[[List_Of_Antibiotics]],
[[Teicoplanin]]	[[List_Of_Antibiotics]],
[[Telavancin]]	[[Lipoglycopeptide]],[[Lipoglycopeptide]],[[List_Of_Antibiotics]],
[[Telithromycin]]	[[List_Of_Antibiotics]],[[Solithromycin]],
[[Temafloxacin]]	[[List_Of_Antibiotics]],
[[Temocillin]]	[[List_Of_Antibiotics]],
[[Tempeh]]	[[Medicinal_Molds]],
[[Template:chembox]]	[[Bottromycin]],
[[Temple_University]]	[[Albert_Schatz_(scientist)]],[[Albert_Schatz_(scientist)]],[[Albert_Schatz_(scientist)]],
[[Tendon]]	[[Antibiotics]],
[[Teniposide]]	[[Medicinal_Molds]],[[Topoisomerase_Inhibitor]],[[Topoisomerase_Inhibitor]],
[[Tequin]]	[[List_Of_Antibiotics]],
[[Teratogenesis]]	[[Cycloheximide]],
[[Teratogenic]]	[[Trichostatin_A]],[[Telavancin]],
[[Teratogenicity]]	[[Nitrofurantoin]],
[[Teratology]]	[[Fusidic_Acid]],
[[Terfeziaceae]]	[[Medicinal_Mushroom]],
[[Terizidone]]	[[Template:Antimycobacterials]],
[[Termitomycesphin]]	[[Medicinal_Mushroom]],
[[Ternatin]]	[[Medicinal_Mushroom]],
[[Terpenoid]]	[[Phytoalexin]],[[Platensimycin]],
[[Terramycin]]	[[List_Of_Antibiotics]],
[[Tertiary_Structure]]	[[Hydramacin-1]],
[[TetR]]	[[SmeT]],
[[Tetracycline]]	[[Antibiotics]],[[Antibiotics]],[[Antibiotics]],[[Mupirocin]],[[Antibiotic_Resistance]],[[Streptomyces_Isolates]],[[Bottromycin]],[[Antibiotic_Resistance]],[[SmeT]],[[List_Of_Antibiotics]],
[[Tetracycline_Antibiotics]]	[[Animal_Drug_Availability_Act_1996]],[[List_Of_Antibiotics]],[[Broad-spectrum_Antibiotic]],[[Platensimycin]],
[[Tetracyclines]]	[[Antibiotic_Resistance]],[[Bacteriostatic_Agent]],
[[Tetrahedron]]	[[Hexamethylenetetramine]],
[[Tetrahydrofolate]]	[[Trimethoprim]],[[Nucleic_Acid_Inhibitor]],
[[Tetrahydrofuran]]	[[Kedarcidin]],
[[Tetronic_Acid]]	[[Pulvinone]],
[[Thailand]]	[[Nitrofurantoin]],
[[The_Cell]]	[[Pyocyanin]],
[[The_International_Pharmacopoeia]]	[[Ethionamide]],
[[The_Journal_Of_Antimicrobial_Chemotherapy]]	[[Fosfomycin]],[[Solithromycin]],
[[The_Journal_Of_Biological_Chemistry]]	[[Pyocyanin]],
[[The_Journal_Of_Immunology]]	[[Pyocyanin]],
[[The_New_York_Times]]	[[Antibiotic_Resistance]],
[[The_Real_News]]	[[Antibiotic_Resistance]],
[[The_Salt_Lake_Tribune]]	[[Ceragenin]],
[[The_Wall_Street_Journal]]	[[GSK_299423]],
[[Theanine]]	[[Medicinal_Mushroom]],
[[Thelephoric_Acid]]	[[Medicinal_Mushroom]],[[Medicinal_Mushroom]],
[[Theophylline]]	[[Cruciferous_Vegetables]],
[[Therapeutic_Index]]	[[Production_Of_Antibiotics]],
[[Therapeutic_Touch]]	[[Albert_Schatz_(scientist)]],
[[Theravance]]	[[Telavancin]],
[[Thermophilic]]	[[Myriocin]],
[[Thiamine]]	[[Platensimycin]],
[[Thiamphenicol]]	[[List_Of_Antibiotics]],
[[Thiazole]]	[[Bottromycin]],
[[Thiazolidine]]	[[Nonribosomal_Peptide]],
[[Thiazoline]]	[[Nonribosomal_Peptide]],
[[Thioamide]]	[[Prothionamide]],
[[Thiocarbamide]]	[[Template:Antimycobacterials]],
[[Thiocarlide]]	[[Template:Antimycobacterials]],
[[Thiocyanate]]	[[Allyl_Isothiocyanate]],
[[Thioester]]	[[Nonribosomal_Peptide]],
[[Thioesterase]]	[[Mupirocin]],[[Echinomycin]],
[[Thiol]]	[[Gliotoxin]],[[Platensimycin]],[[Esperamicin]],
[[Thiolate]]	[[Kedarcidin]],
[[Thiomersal]]	[[Bacteriostatic_Agent]],
[[Thiosulfinate]]	[[Allicin]],
[[Thiourea]]	[[Thiocarlide]],
[[Thomas_Hager]]	[[The_Demon_Under_The_Microscope]],
[[Threonine]]	[[Nonribosomal_Peptide]],[[User:Harmonslide/sandbox]],[[Katanosin]],
[[Throat]]	[[Xibornol]],
[[Thrombocytopenia]]	[[Ristocetin]],[[Trimethoprim]],[[Daptomycin]],[[List_Of_Antibiotics]],
[[Thrombocytosis]]	[[Daptomycin]],
[[Thrombosis]]	[[Allicin]],
[[Thymidine_Triphosphate]]	[[Thymineless_Death]],
[[Thymidylate]]	[[Esperamicin]],
[[Thymine]]	[[Thymineless_Death]],
[[Thymocyte]]	[[Gliotoxin]],
[[Thyroid_Hormone]]	[[4-Aminosalicylic_Acid]],[[Triclosan]],[[Cruciferous_Vegetables]],
[[Thyroxine]]	[[Raphanin]],
[[Tiamulin]]	[[Medicinal_Mushroom]],
[[Ticarcillin]]	[[Extended-spectrum_Penicillin]],[[List_Of_Antibiotics]],[[Broad-spectrum_Antibiotic]],
[[Tigecycline]]	[[Bacteriostatic_Agent]],[[List_Of_Antibiotics]],[[Antibiotics]],
[[Timeline_Of_Antibiotics]]	[[List_Of_Antibiotics]],
[[Tinidazole]]	[[List_Of_Antibiotics]],[[Antibiotics]],
[[Tobramycin]]	[[Tobramycin/dexamethasone]],[[Fosfomycin/tobramycin]],[[Fosfomycin/tobramycin]],[[List_Of_Antibiotics]],
[[Tohoku_University]]	[[Kedarcidin]],
[[Tolypocladium_Inflatum]]	[[Medicinal_Molds]],
[[Tomato_Juice]]	[[4-Aminosalicylic_Acid]],
[[Toothpaste]]	[[Triclosan]],[[Triclosan]],
[[Topical]]	[[Antibiotics]],
[[Topical_Anesthetic]]	[[Allyl_Isothiocyanate]],
[[Topoisomerase]]	[[List_Of_Antibiotics]],[[GSK_299423]],[[Topoisomerase_Inhibitor]],
[[Topoisomerase_II]]	[[Topoisomerase_Inhibitor]],
[[Topoisomerase_IV]]	[[Antibiotic_Resistance]],
[[Topoisomerase_I]]	[[Topoisomerase_Inhibitor]],
[[Topoisomerase_Inhibitor]]	[[Nucleic_Acid_Inhibitor]],
[[Topotecan]]	[[Topoisomerase_Inhibitor]],[[Medicinal_Molds]],[[A23187]],
[[Torezolid]]	[[List_Of_Antibiotics]],
[[Total_Synthesis]]	[[Platensimycin]],[[User:Harmonslide/sandbox]],[[Monensin]],[[Pulvinone]],[[Kendomycin]],[[Streptazolin]],
[[Toxic]]	[[Hydramacin-1]],
[[Toxicity]]	[[Isoniazid]],
[[Toxicity_To_Kidneys]]	[[Kanamycin]],
[[Toxicology]]	[[Arenicin]],
[[Toxicology_And_Applied_Pharmacology]]	[[Allyl_Isothiocyanate]],
[[Toxin]]	[[Nonribosomal_Peptide]],
[[Toxoplasmosis]]	[[Dapsone]],
[[Tr:Sebzelerden]]	[[Cruciferous_Vegetables]],
[[Trade_Name]]	[[Arsphenamine]],[[Erythromycin/sulfafurazole]],[[Trimethoprim]],
[[Traditional_Chinese_Medicine]]	[[Raphanin]],[[Streptomyces_Isolates]],
[[Traditional_Korean_Medicine]]	[[Allistatin]],
[[Trametenolic_Acid]]	[[Medicinal_Mushroom]],
[[Trametes_Gibbosa]]	[[Medicinal_Mushroom]],
[[Trametes_Versicolor]]	[[Medicinal_Mushroom]],[[Medicinal_Mushroom]],
[[Tranilast]]	[[Avenanthramide]],
[[Transcription_Factor]]	[[Pyocyanin]],
[[Transcription_Factors]]	[[Trichostatin_A]],
[[Transcriptional_Regulator]]	[[Bottromycin]],
[[Transcriptional_Repressor]]	[[Ethionamide]],
[[Transduction_(genetics)]]	[[Antibiotic_Resistance]],
[[Transfer_RNA]]	[[List_Of_Antibiotics]],
[[Transformation_(genetics)]]	[[Antibiotic_Resistance]],[[Kanamycin]],
[[Transgenic]]	[[Medicinal_Molds]],
[[Translation_(biology)]]	[[User:Harmonslide/sandbox]],
[[Translation_(genetics)]]	[[Blasticidin_S]],[[Cycloheximide]],
[[Transposon]]	[[Efflux_(microbiology)]],[[Kanamycin]],
[[Trehalase]]	[[Validamycin]],
[[Tremella_Fuciformis]]	[[Medicinal_Mushroom]],
[[Tremella_Mesenterica]]	[[Medicinal_Mushroom]],
[[Tremor]]	[[Antibiotic_Misuse]],
[[Trends_In_Molecular_Medicine]]	[[Pyocyanin]],
[[Treponema_Pallidum]]	[[Arsphenamine]],
[[Triangle_Of_U]]	[[Cruciferous_Vegetables]],
[[Trichoderma]]	[[Gliotoxin]],[[Peptaibol]],
[[Tricholoma_Matsutake]]	[[Medicinal_Mushroom]],
[[Tricholomalide]]	[[Medicinal_Mushroom]],
[[Trichomoniasis]]	[[List_Of_Antibiotics]],
[[Trichophyton]]	[[Antibiotic_Resistance]],
[[Triclocarban]]	[[Triclosan]],[[Triclosan]],[[Triclosan]],[[Triclosan]],
[[Triclosan]]	[[Mupirocin]],[[Platensimycin]],
[[Triethylamine]]	[[Kedarcidin]],
[[Trimer_(chemistry)]]	[[Arsphenamine]],
[[Trimethoprim]]	[[Trimethoprim/polymyxin]],[[Bacteriostatic_Agent]],[[Dapsone]],[[List_Of_Antibiotics]],[[List_Of_Antibiotics]],[[Mupirocin]],[[Thymineless_Death]],
[[Trinity_College,_Dublin]]	[[Clofazimine]],
[[Triple_Bond]]	[[Enediyne]],
[[Tris]]	[[Fosfomycin]],
[[Triterpenoids]]	[[Medicinal_Mushroom]],
[[Troleandomycin]]	[[List_Of_Antibiotics]],
[[Tropical]]	[[Endiandric_Acid_C]],
[[Trovafloxacin]]	[[List_Of_Antibiotics]],
[[Trovan]]	[[List_Of_Antibiotics]],
[[Trypanosoma_Brucei]]	[[Ascofuranone]],
[[Tryptone]]	[[Aspergillic_Acid]],
[[Tryptophan]]	[[Daptomycin]],
[[Tubercle_Bacillus]]	[[Albert_Schatz_(scientist)]],[[Albert_Schatz_(scientist)]],
[[Tuberculosis]]	[[Thiocarlide]],[[4-Aminosalicylic_Acid]],[[Antibiotics]],[[Antibiotic_Resistance]],[[Promin]],[[Thioacetazone]],[[Ethambutol]],[[Ethambutol]],[[Ethambutol]],[[Enviomycin]],[[Albert_Schatz_(scientist)]],[[Antibiotic_Resistance]],[[Prothionamide]],[[Thioacetazone]],[[Isoniazid]],[[Alliance_For_The_Prudent_Use_Of_Antibiotics]],[[Ansamycin]],[[List_Of_Antibiotics]],[[Myxopyronin]],[[Isoniazid]],[[Ethionamide]],
[[Tuberculosis_Treatment]]	[[4-Aminosalicylic_Acid]],[[Ethambutol]],[[Template:Antimycobacterials]],[[Isoniazid]],
[[Tuberculostatic_Drug]]	[[Furonazide]],
[[Tuberculostearic_Acid]]	[[Thiocarlide]],
[[Tufts_University]]	[[Alliance_For_The_Prudent_Use_Of_Antibiotics]],
[[Tularemia]]	[[List_Of_Antibiotics]],
[[Tumor]]	[[Geldanamycin]],[[Hitachimycin]],[[Herbimycin]],[[Neocarzinostatin]],[[Phytoalexin]],
[[Tumors]]	[[Tanespimycin]],[[Tanespimycin]],
[[Turnip]]	[[Cruciferous_Vegetables]],
[[Tympanostomy_Tube]]	[[Antibiotic_Misuse]],
[[Type_1_Diabetes]]	[[Clofazimine]],
[[Type_III_Secretion_System]]	[[Streptomyces_Isolates]],
[[Typhoid]]	[[Pyocyanase]],
[[Typhus]]	[[List_Of_Antibiotics]],
[[Tyrocidine]]	[[Nonribosomal_Peptide]],[[Antibiotics]],
[[Tyrosine]]	[[Pulvinone]],[[Kedarcidin]],[[Kedarcidin]],
[[Tyrothricin]]	[[Tyrocidine]],[[Antibiotics]],[[Tyrocidine]],
[[UC_San_Diego_Health_System]]	[[Staurosporine]],
[[USA300]]	[[Antibiotic_Resistance]],
[[USA400]]	[[Antibiotic_Resistance]],
[[UV]]	[[Triclosan]],
[[Ubenimex]]	[[Streptomyces_Isolates]],
[[Ubiquinol]]	[[Antimycin_A]],
[[Ulcerative_Colitis]]	[[4-Aminosalicylic_Acid]],[[Dapsone]],
[[Unconditioned_Stimulus]]	[[Cycloserine]],
[[Unfolded_Protein_Response]]	[[Tunicamycin]],
[[Union_Of_Concerned_Scientists]]	[[Antibiotic_Resistance]],[[Subtherapeutic_Antibiotic_Use_In_Swine]],
[[Uniporter]]	[[Efflux_(microbiology)]],
[[United_Kingdom]]	[[Antibiotic_Resistance]],
[[United_States]]	[[Antibiotic_Resistance]],[[Telavancin]],[[Antibiotic_Resistance]],
[[United_States_Adopted_Name]]	[[Thioacetazone]],
[[United_States_Department_Of_Agriculture]]	[[Antibiotic_Resistance]],
[[United_States_District_Court_For_The_Southern_District_Of_New_York]]	[[Antibiotic_Resistance]],
[[United_States_Federal_Law]]	[[Animal_Drug_Availability_Act_1996]],
[[United_States_House_Committee_On_Energy_And_Commerce]]	[[Animal_Drug_Availability_Act_1996]],
[[United_States_Pharmacopeia]]	[[Ethionamide]],
[[University_Of_California,_Los_Angeles]]	[[Glycyrrhizol]],
[[University_Of_Cambridge]]	[[Salinomycin]],
[[University_Of_Chile]]	[[Albert_Schatz_(scientist)]],[[Albert_Schatz_(scientist)]],
[[Upjohn]]	[[Aminocoumarin]],[[Novobiocin]],
[[Upper_Respiratory_Tract_Infection]]	[[List_Of_Antibiotics]],
[[Urea]]	[[Bottromycin]],
[[Ureidopenicillin]]	[[Extended-spectrum_Penicillin]],[[Extended-spectrum_Penicillin]],
[[Uremia]]	[[Isoniazid]],
[[Urinary_Tract_Infection]]	[[Fosfomycin]],[[List_Of_Antibiotics]],[[Nitrofurantoin]],[[Trimethoprim]],[[Antibiotic_Misuse]],[[Multidrug_Tolerance]],
[[Urinary_Tract_Infections]]	[[Trimethoprim]],[[List_Of_Antibiotics]],[[Arenicin]],[[List_Of_Antibiotics]],
[[Urine]]	[[Nitrofurantoin]],
[[Urticaria]]	[[Nitrofurantoin]],
[[Use_Of_Antimicrobial_Agents_In_The_Food_Industry]]	[[Alliance_For_The_Prudent_Use_Of_Antibiotics]],
[[Usnic_Acid]]	[[Medicinal_Mushroom]],
[[Ustilago_Maydis]]	[[Medicinal_Mushroom]],
[[Utah]]	[[Archaeocin]],
[[Uterine_Tumor]]	[[Endiandric_Acid_C]],
[[Vaccine]]	[[Antibiotics]],[[Antibiotic_Resistance]],[[Medicinal_Mushroom]],
[[Vaccines]]	[[Antibiotics]],
[[Vaginal_Flora]]	[[Antibiotics]],
[[Valence_(chemistry)]]	[[Surfactin]],
[[Valine]]	[[Gramicidin_S]],[[Katanosin]],[[Surfactin]],
[[Valnemulin]]	[[Medicinal_Mushroom]],
[[Valrubicin]]	[[Streptomyces_Isolates]],
[[Value_(economics)]]	[[Production_Of_Antibiotics]],
[[Vancocin]]	[[List_Of_Antibiotics]],
[[Vancomycin]]	[[Nonribosomal_Peptide]],[[Daptomycin]],[[Platensimycin]],[[Daptomycin]],[[Telavancin]],[[Bottromycin]],[[Katanosin]],[[Dalfopristin]],[[Telavancin]],[[List_Of_Antibiotics]],[[Antibiotic_Resistance]],
[[Vantin]]	[[List_Of_Antibiotics]],
[[Variegatic_Acid]]	[[Pulvinone]],
[[Vector_(epidemiology)]]	[[Phytoalexin]],
[[Vegemite]]	[[Medicinal_Mushroom]],[[Medicinal_Molds]],
[[Vegetable]]	[[Cruciferous_Vegetables]],
[[Venom]]	[[Hydramacin-1]],
[[Verapamil]]	[[Efflux_(microbiology)]],
[[Vermiculine]]	[[Medicinal_Molds]],
[[Verrucarin_A]]	[[Medicinal_Molds]],[[Medicinal_Mushroom]],
[[Vertigo]]	[[Cycloserine]],
[[Vertigo_(medical)]]	[[List_Of_Antibiotics]],[[Daptomycin]],
[[Veterinary_Medicine]]	[[Furazolidone]],[[Avenanthramide]],[[Broad-spectrum_Antibiotic]],[[Antibiotic_Resistance]],
[[Vibativ]]	[[List_Of_Antibiotics]],
[[Vibramycin]]	[[List_Of_Antibiotics]],
[[Vietnam]]	[[Nitrofurantoin]],
[[Vinblastine]]	[[Medicinal_Molds]],[[Medicinal_Molds]],
[[Vincamine]]	[[Medicinal_Molds]],
[[Vincristine]]	[[Medicinal_Molds]],[[Medicinal_Molds]],
[[Vinylogous]]	[[Pulvinone]],
[[Viral_Infection]]	[[Tobramycin/dexamethasone]],
[[Viral_Protein]]	[[Antibiotic_Resistance]],
[[Virginiamycin]]	[[Pristinamycin]],[[Streptogramin]],[[Dalfopristin]],
[[Virulence]]	[[Efflux_(microbiology)]],
[[Virus]]	[[Surfactin]],[[Allistatin]],
[[Visual_Molecular_Dynamics]]	[[Netropsin]],
[[Vitamin]]	[[Allistatin]],
[[Vitamin_C]]	[[Cruciferous_Vegetables]],
[[Vitamin_D]]	[[Cathelicidin]],[[Cathelicidin]],[[Medicinal_Mushroom]],
[[Vitis_Vinifera]]	[[Phytoalexin]],
[[Vitronectin]]	[[Thiolutin]],
[[Volvariella_Volvacea]]	[[Medicinal_Mushroom]],
[[Von_Willebrand_Disease]]	[[Ristocetin]],
[[Von_Willebrand_Factor]]	[[Ristocetin]],
[[Vorinostat]]	[[Trichostatin_A]],
[[Vulpinic_Acid]]	[[Pulvinone]],[[Pulvinone]],[[Pulvinone]],
[[WHO]]	[[Daptomycin]],
[[Wasabi]]	[[Allicin]],[[Cruciferous_Vegetables]],[[Allyl_Isothiocyanate]],[[Cruciferous_Vegetables]],
[[Washington_University]]	[[Albert_Schatz_(scientist)]],[[Albert_Schatz_(scientist)]],
[[Washington_University_School_Of_Medicine]]	[[Promin]],
[[Wastewater]]	[[Triclosan]],
[[Water]]	[[Surfactin]],[[Platensimycin]],
[[Watercress]]	[[Cruciferous_Vegetables]],
[[Wayne_Allard]]	[[Animal_Drug_Availability_Act_1996]],
[[Weight_Gain]]	[[Animal_Drug_Availability_Act_1996]],
[[Western_Blotting]]	[[Cycloheximide]],
[[Wheat]]	[[Beauvericin]],
[[White_Blood_Cell]]	[[List_Of_Antibiotics]],[[Dapsone]],
[[White_Mustard]]	[[Cruciferous_Vegetables]],
[[Whooping_Cough]]	[[Allistatin]],
[[Wikipedia:Footnotes]]	[[SmeT]],
[[Wikt:antagonism]]	[[Antibiotics]],
[[Wikt:subtherapeutic]]	[[Subtherapeutic_Antibiotic_Use_In_Swine]],
[[Wikt:transient]]	[[Multidrug_Tolerance]],
[[Wiktionary:oral]]	[[Kanamycin]],
[[Wild_Type]]	[[Production_Of_Antibiotics]],[[Platensimycin]],
[[Wood_Preservation]]	[[Phytoalexin]],
[[World_Health_Organisation]]	[[Isoniazid]],
[[World_Health_Organization]]	[[Antibiotic_Resistance]],[[Antibiotic_Resistance]],[[Animal_Drug_Availability_Act_1996]],[[Antibiotic_Resistance]],[[Alliance_For_The_Prudent_Use_Of_Antibiotics]],[[Antibiotic_Resistance]],
[[Wortmannin]]	[[Medicinal_Molds]],
[[Wrapped_Heart_Mustard_Cabbage]]	[[Cruciferous_Vegetables]],
[[Wyeth]]	[[Pulvinone]],
[[Wyeth_Pharmaceuticals]]	[[Ethionamide]],
[[Xanthine_Oxidase]]	[[Medicinal_Mushroom]],
[[Xantocillin]]	[[Questiomycin_A]],
[[Xenobiotic_Metabolism]]	[[Efflux_(microbiology)]],
[[Xithrone]]	[[List_Of_Antibiotics]],
[[Xylaria_Hypoxylon]]	[[Medicinal_Mushroom]],
[[Yamaguchi_Esterification]]	[[Kedarcidin]],
[[Yangonin]]	[[Endiandric_Acid_C]],
[[YcaO]]	[[Bottromycin]],
[[Yeast]]	[[Hitachimycin]],[[Gliotoxin]],[[Reuterin]],
[[Yeast_Extract]]	[[Medicinal_Molds]],[[Medicinal_Mushroom]],
[[Yersinia]]	[[Trimethoprim]],[[Nifuroxazide]],
[[Za:Kruis_Bloemig_Groente]]	[[Cruciferous_Vegetables]],
[[Zagam]]	[[List_Of_Antibiotics]],
[[Zaragozic_Acid]]	[[Medicinal_Molds]],
[[Zeftera]]	[[List_Of_Antibiotics]],
[[Zhankuic_Acid]]	[[Medicinal_Mushroom]],
[[Zinc]]	[[Aspergillic_Acid]],
[[Zinc_Oxide]]	[[Efflux_(microbiology)]],
[[Zinnat]]	[[List_Of_Antibiotics]],
[[Zithromax]]	[[List_Of_Antibiotics]],
[[Zorubicin]]	[[Streptomyces_Isolates]],
[[Zwitterion]]	[[Gramicidin_S]],[[Staurosporine]],[[Pyocyanin]],
[[Zwittermicin_A]]	[[Nonribosomal_Peptide]],
[[Zymosan]]	[[Medicinal_Mushroom]],[[Medicinal_Molds]],
[[Zyvox]]	[[List_Of_Antibiotics]],
